Unnamed: 0,SOCIO- DEMOGRAPHIC ,Unnamed: 2,Unnamed: 3,Unnamed: 4,Unnamed: 5,Unnamed: 6,Unnamed: 7,Unnamed: 8,Unnamed: 9,Unnamed: 10,EMPLOYMENT STATUS ,Unnamed: 12,Unnamed: 13,Unnamed: 14,Unnamed: 15,Unnamed: 16,Unnamed: 17,SELF MANAGEMENT ,Unnamed: 19,Unnamed: 20,Unnamed: 21,Unnamed: 22,Unnamed: 23,Unnamed: 24,Unnamed: 25,Unnamed: 26,Unnamed: 27,FAMILY ATTACHMENTS,Unnamed: 29,Unnamed: 30,Unnamed: 31,Unnamed: 32,Unnamed: 33,Unnamed: 34,Unnamed: 35,Unnamed: 36,Unnamed: 37,Unnamed: 38,Unnamed: 39,Unnamed: 40,SOCIAL INTERACTION,Unnamed: 42,Unnamed: 43,Unnamed: 44,Unnamed: 45,Unnamed: 46,Unnamed: 47,Unnamed: 48,HEALTH,Unnamed: 50,Unnamed: 51,Unnamed: 52,Unnamed: 53,Unnamed: 54,Unnamed: 55,Unnamed: 56,WORKING STYLE ,Unnamed: 58,Unnamed: 59,Unnamed: 60,Unnamed: 61,Unnamed: 62,Unnamed: 63,Unnamed: 64,Unnamed: 65,Unnamed: 66,Unnamed: 67,Unnamed: 68,Unnamed: 69,Unnamed: 70,Unnamed: 71,Unnamed: 72,Unnamed: 73,Unnamed: 74,Unnamed: 75,Unnamed: 76,Unnamed: 77,Unnamed: 78,Unnamed: 79,Unnamed: 80,Unnamed: 81,Unnamed: 82,Unnamed: 83,Unnamed: 84,Unnamed: 85,PERSONAL EFFORTS,Unnamed: 87,Unnamed: 88,Unnamed: 89,INSTITUTIONAL EFFORTS,Unnamed: 91,Unnamed: 92,Unnamed: 93,Unnamed: 94,Unnamed: 95,Unnamed: 96,Unnamed: 97,Unnamed: 98,Unnamed: 99,Unnamed: 100,Unnamed: 101,Unnamed: 102,WORK LIFE BALANCE ,Unnamed: 104,Unnamed: 105,Unnamed: 106,Unnamed: 107,Unnamed: 108,Unnamed: 109,Unnamed: 110,Unnamed: 111,Unnamed: 112,Unnamed: 113,Unnamed: 114,Unnamed: 115
NO OF RESPONDENTS,SEX,AGE,RELIGION,MARITAL STATUS,YES JOB,YES NATURE ,ETHINITY,NATURE OF FAMILY,EDUCTAIONAL ,MONTHLY INCOME,PRESENT POSITION,YES WORKING ,NATURE OF APPOINMENT ,NO.OF.HOURS SPENT IN BANK,NO OF EMPLOYESS,SATISFACTION,WORK LIFE BALANCE,SM1,SM2,SM3,SM4,SM5,SM6,SM7,SM8,SM9,SM10,FA1,FA2,FA3,FA4,FA5,FA6,FA7,FA8,FA9,FA10,FA11,FA12,FA13,SI1,SI2,SI3,SI4,SI5,SI6,SI7,SI8,H1,H2,H3,H4,H5,H6,H7,H8,WS1,WS2,WS3,WS4,WS5,WS6,WS7,WS8,WS9,WS10,WS11,WS12,WS13,WS14,WS15,WS16,WS17,WS18,WS19,WS20,WS21,WS22,WS23,WS24,WS25,WS26,WS27,WS28,WS29,PE1,PE2,PE3,PE4,IE1,IE2,IE3,IE4,IE5,IE6,IE7,IE8,IE9,IE10,IE11,IE12,IE13,WLB1,WLB2,WLB3,WLB4,WLB5,WLB6,WLB7,WLB8,WLB9,WLB10,WLB11,WLB12,WLB13
1,2,1,1,2,0,0,2,2,3,1,2,2,1,1,10,1,1,2,2,1,1,1,3,5,4,4,2,1,2,4,3,3,3,4,4,3,2,5,4,5,3,3,3,2,3,2,2,5,2,4,1,4,4,1,2,2,5,4,4,3,4,4,3,1,5,3,2,5,4,5,4,3,5,4,4,4,4,5,4,4,4,1,1,2,1,2,2,2,1,2,2,1,1,2,1,1,2,2,2,2,1,1,2,3,3,3,4,4,4,2,4,3,3,3,1
2,1,2,1,1,1,2,1,1,3,2,2,3,1,2,10,1,1,2,2,3,1,3,1,1,2,3,2,3,2,3,1,5,2,2,4,2,1,4,1,2,1,2,1,1,3,1,1,2,1,1,1,1,3,4,2,4,5,5,2,5,2,3,5,1,3,2,4,5,2,4,3,3,5,5,4,5,5,5,5,4,5,5,3,5,5,2,1,2,1,2,2,1,1,2,1,1,2,2,1,1,1,1,4,2,4,4,2,3,2,2,4,2,4,4,2
3,1,3,1,1,1,1,1,1,4,2,1,4,1,2,10,1,1,4,4,2,3,2,2,2,5,2,5,5,3,5,5,3,5,4,5,5,2,3,1,3,5,4,5,3,5,4,2,5,1,5,2,3,2,3,4,1,5,4,3,2,4,3,2,1,3,5,5,5,5,5,3,2,5,5,5,5,3,5,5,5,4,5,2,3,1,2,2,2,1,1,2,2,1,2,1,1,2,2,2,2,1,1,5,2,2,5,4,3,2,5,2,3,5,4,3
4,2,1,1,1,1,2,1,1,5,2,2,3,1,2,10,1,1,3,2,1,3,4,1,1,1,1,1,1,2,1,4,3,2,1,2,2,2,3,1,3,2,3,2,5,5,2,1,2,1,1,1,2,2,2,1,2,1,2,1,1,3,3,3,1,1,2,2,2,4,3,1,1,3,4,3,5,2,2,1,2,5,5,1,5,5,2,2,2,2,2,2,1,2,2,1,1,1,2,2,1,1,1,2,2,2,2,4,4,3,2,3,3,2,2,2
5,1,4,1,1,1,3,2,1,4,4,2,4,1,2,10,1,1,3,2,2,1,5,2,1,1,1,2,2,2,5,2,5,2,5,1,5,1,5,3,1,3,3,3,3,5,1,1,1,3,1,1,1,1,1,1,4,4,4,5,3,2,2,2,1,1,3,3,5,5,3,4,4,5,4,4,4,3,5,5,3,4,5,1,5,5,2,2,2,1,2,2,2,2,2,1,1,2,2,2,1,2,1,3,1,2,5,4,4,2,3,4,2,4,5,2
6,2,2,1,1,1,2,1,2,3,2,2,4,1,3,10,1,1,5,1,4,5,5,5,3,4,4,5,2,5,5,5,3,1,5,2,5,4,4,5,4,2,3,3,3,5,2,5,1,5,5,5,3,3,1,5,4,5,5,5,5,5,2,3,3,5,4,4,2,4,4,5,5,2,2,5,5,2,5,5,5,5,5,5,1,3,2,2,2,2,1,1,1,1,2,1,1,1,2,2,1,2,1,5,2,2,1,5,5,1,3,3,4,5,5,2
7,1,2,1,1,1,2,1,2,3,2,1,4,1,2,10,1,1,3,5,2,5,2,5,1,3,1,2,1,4,5,5,5,4,3,2,5,5,3,2,1,4,3,1,1,4,1,4,5,3,1,2,4,3,1,1,3,5,5,4,3,5,5,5,1,3,5,5,5,5,4,3,3,2,4,5,2,1,3,3,2,5,3,3,5,5,1,2,2,1,1,2,1,1,1,2,1,2,2,1,1,1,1,2,2,2,3,4,3,2,2,4,2,5,5,3
8,1,2,1,1,2,0,2,1,3,4,2,3,1,4,10,1,2,2,2,2,2,3,4,1,2,2,5,2,1,3,3,2,3,2,3,2,2,4,4,4,2,2,2,2,2,4,3,3,2,2,2,2,2,2,2,3,2,2,3,3,3,3,3,3,3,3,3,3,3,2,3,3,3,3,3,3,3,3,3,3,3,3,2,3,3,1,1,2,1,1,1,1,2,1,1,1,1,1,1,1,1,1,2,2,2,3,2,2,2,1,3,2,1,1,3
9,1,2,1,1,1,2,2,2,4,2,1,4,1,2,10,1,1,4,5,2,5,4,4,2,3,4,1,3,5,5,4,4,3,2,4,2,2,5,4,3,3,5,2,2,2,2,3,4,2,4,1,3,3,2,1,4,2,1,4,1,3,3,3,3,3,3,4,5,1,5,3,5,5,3,3,5,1,3,3,2,5,5,5,1,1,1,2,2,2,1,2,2,1,2,1,1,2,2,2,1,2,1,5,4,5,4,4,3,3,3,5,3,4,3,5
10,1,2,1,1,1,2,1,2,3,1,2,1,1,1,10,1,1,5,4,2,2,1,1,1,5,2,3,5,3,1,1,1,4,2,4,2,3,3,5,3,2,2,4,2,5,3,4,3,2,3,2,2,2,2,3,2,4,4,4,3,4,4,4,2,4,3,4,3,3,4,4,4,3,4,4,4,3,4,4,4,4,3,2,2,2,2,2,2,2,1,2,2,1,2,2,1,2,2,1,1,1,1,2,3,3,4,4,4,3,4,3,2,5,5,2
11,1,2,1,1,2,0,2,2,4,3,2,2,1,2,10,1,1,3,3,2,3,2,4,2,4,4,3,3,3,2,4,4,3,3,2,3,2,2,1,1,3,3,3,3,4,4,2,2,2,3,2,4,3,2,3,2,3,4,4,2,4,4,4,2,3,4,4,4,4,3,2,4,4,3,5,3,2,4,4,3,4,2,2,2,2,2,1,2,1,1,2,1,1,2,1,1,2,2,2,2,2,1,4,4,4,4,3,4,2,4,3,3,3,4,2
12,1,2,1,2,0,0,1,2,4,3,2,4,1,2,10,1,2,3,3,3,2,1,1,3,2,2,3,1,3,3,1,3,1,3,3,3,2,2,2,3,3,2,3,1,3,2,2,2,4,1,1,1,1,1,2,2,2,2,3,2,2,3,3,4,2,1,1,3,2,2,3,3,3,3,3,3,4,4,2,2,2,3,4,3,3,2,1,1,1,2,2,2,2,2,1,1,2,2,2,2,1,2,2,1,2,3,4,4,3,3,3,1,4,5,3
13,1,2,1,2,0,0,2,1,3,1,2,3,1,2,10,1,2,5,5,5,5,3,3,2,3,3,4,5,4,2,4,3,3,3,5,4,2,5,3,2,5,4,4,3,5,5,3,3,3,3,2,2,2,1,3,3,3,3,3,3,3,5,3,1,1,3,1,5,5,3,3,3,5,3,3,3,3,5,3,3,5,3,4,2,2,2,2,1,1,2,2,2,2,2,1,1,2,2,2,2,1,1,2,2,2,4,4,4,4,2,4,3,5,5,3
14,1,2,1,2,0,0,1,2,3,4,2,2,1,2,10,2,1,3,2,1,3,3,3,1,3,3,5,5,5,3,1,5,5,4,2,1,3,5,1,3,1,3,3,3,3,1,2,3,1,1,1,3,4,2,2,2,4,4,3,2,4,3,3,5,4,2,4,1,5,5,1,3,5,4,5,3,3,3,4,4,4,4,3,2,1,2,1,1,1,1,2,1,2,2,1,1,1,2,1,2,1,1,4,5,2,1,5,4,5,4,2,1,5,5,2
15,1,2,1,2,0,0,1,2,4,3,2,2,1,2,10,1,2,2,2,1,4,3,5,4,5,3,1,4,2,4,2,4,4,3,5,3,1,3,1,3,1,2,3,2,5,2,3,4,1,3,3,3,3,2,5,5,3,2,3,3,2,4,3,1,3,3,4,5,4,4,3,3,3,3,4,2,3,3,3,5,1,1,1,1,3,1,1,1,1,1,2,1,1,2,1,1,2,2,2,2,1,1,3,4,4,4,4,5,2,2,4,3,4,5,4
16,1,1,1,2,0,0,1,2,3,4,2,3,1,3,10,1,1,3,3,2,3,3,4,2,3,4,4,1,3,3,3,1,2,3,3,2,2,4,2,2,4,2,2,1,3,4,3,2,3,4,4,4,4,2,2,2,4,4,4,3,1,2,4,3,4,4,4,3,2,4,2,3,3,4,4,3,2,4,3,3,4,4,2,2,1,2,2,1,1,2,2,2,1,1,2,1,2,2,2,2,1,1,4,2,5,4,4,4,5,3,4,5,5,5,4
17,1,2,1,1,2,0,1,1,3,4,2,2,1,2,10,1,2,3,3,2,3,5,5,4,3,4,2,4,4,4,3,5,3,2,2,3,5,3,1,5,3,4,4,3,4,1,2,5,2,3,1,5,4,2,3,2,2,3,4,3,3,2,2,3,3,2,2,1,4,2,3,4,2,4,4,2,2,5,5,4,5,1,4,1,2,2,1,2,1,1,2,1,2,2,1,2,1,1,1,1,2,2,3,4,4,5,4,2,2,3,4,3,3,3,3
18,1,1,3,2,0,0,2,2,4,2,2,1,1,2,10,2,2,2,3,2,5,3,4,5,2,1,2,2,2,4,2,3,2,2,1,2,2,4,1,3,1,2,3,2,2,1,2,2,1,5,3,2,5,1,2,1,4,4,2,3,3,4,3,1,1,1,2,4,3,5,3,4,1,4,3,4,1,4,4,2,3,5,2,1,4,2,2,2,1,1,1,1,1,2,1,1,1,1,1,1,1,1,1,1,1,5,5,3,3,3,2,1,5,4,4
19,1,1,1,2,0,0,1,1,4,2,2,1,1,1,10,1,1,4,4,5,5,4,3,2,2,3,1,4,4,2,5,3,5,3,2,3,3,1,1,3,3,3,4,3,5,1,2,4,3,4,3,5,4,2,3,3,3,5,2,2,4,4,4,2,2,4,4,3,4,5,5,3,3,4,5,3,2,4,4,2,5,3,2,2,2,2,2,2,2,2,2,1,1,1,1,1,2,1,1,2,1,1,2,3,3,2,4,3,2,3,2,3,4,4,2
20,1,2,1,1,1,1,2,1,3,4,2,4,1,2,10,2,2,3,4,3,2,2,3,1,3,5,2,3,4,2,2,2,3,2,2,1,2,2,2,2,2,4,2,4,5,2,3,4,2,3,2,4,3,2,1,3,3,4,3,3,4,3,3,3,4,3,2,3,4,4,5,4,4,2,5,3,4,5,5,2,4,1,1,2,3,2,1,2,1,2,2,1,1,2,1,1,1,2,1,1,1,1,4,2,4,2,4,3,2,1,3,4,4,3,2
21,1,2,1,1,1,2,2,2,4,4,2,2,2,2,10,1,2,1,3,2,1,2,1,1,2,3,1,2,3,2,3,4,1,1,5,2,2,1,4,5,2,3,2,3,3,1,3,2,2,1,2,1,3,2,3,4,3,4,4,5,5,3,2,2,1,3,5,1,2,3,2,3,1,3,4,5,2,3,2,1,4,3,2,2,3,2,2,2,1,1,2,1,2,2,1,1,1,1,2,2,1,1,4,4,2,2,4,3,1,3,1,4,4,5,2
22,1,2,1,2,0,0,2,2,3,4,2,2,1,2,10,1,1,3,3,2,2,3,3,3,2,2,3,3,3,4,3,3,1,2,3,2,1,2,1,3,4,3,3,3,3,2,2,4,1,1,2,2,2,5,2,4,3,3,3,2,5,4,4,2,3,4,5,4,3,5,3,2,2,3,3,3,4,4,5,2,4,1,1,1,1,2,2,2,1,2,2,1,1,2,1,2,2,2,2,2,2,1,2,2,2,2,3,2,2,4,4,3,4,4,3
23,1,2,1,1,2,0,2,2,3,4,1,4,1,2,10,1,1,3,3,2,2,3,3,3,4,2,2,1,3,4,4,3,3,1,3,5,1,2,1,1,2,3,2,2,4,2,2,4,1,1,2,2,3,2,2,4,3,3,3,2,5,4,4,2,3,4,4,4,3,5,3,2,2,3,3,3,3,4,4,3,4,1,1,1,2,1,1,2,1,2,2,1,1,2,1,2,2,2,2,1,2,1,2,2,2,2,3,2,2,2,4,3,4,5,3
24,1,2,1,2,0,0,2,2,4,4,2,2,1,2,10,1,1,5,4,3,4,2,5,1,3,2,2,5,3,4,3,1,2,3,2,2,1,4,1,1,1,1,3,3,1,1,2,2,1,4,1,1,1,1,1,1,3,1,3,3,2,1,1,1,3,3,2,2,1,4,1,1,1,1,2,3,2,3,3,3,4,4,3,2,2,1,1,1,1,1,1,2,2,1,1,1,2,2,1,1,1,1,2,4,2,3,4,3,3,2,3,2,5,4,4
25,1,1,1,2,0,0,1,2,4,3,2,1,1,2,10,2,2,2,2,2,3,3,5,4,3,4,2,4,2,3,4,1,2,3,4,2,1,1,2,3,1,1,3,3,3,2,2,3,1,1,1,1,1,1,3,3,3,2,3,3,4,4,3,1,3,3,4,4,1,5,3,4,1,2,3,3,2,3,3,3,2,4,3,3,2,1,1,1,2,1,1,2,2,2,1,1,2,2,2,1,1,1,3,4,4,3,4,4,2,4,3,2,4,5,3
26,1,2,2,3,0,0,2,2,3,4,1,3,1,3,10,2,2,4,4,3,2,1,1,1,1,1,1,1,1,3,1,2,2,5,2,3,2,1,2,4,1,2,2,3,3,2,1,2,2,2,3,2,2,3,2,2,3,3,3,4,5,4,3,2,2,2,3,2,3,5,4,1,2,3,2,4,4,3,4,2,3,3,4,5,5,1,1,2,1,1,1,1,1,1,1,1,1,1,1,1,2,1,1,1,1,1,1,1,1,3,4,1,5,5,3
27,1,3,3,1,2,0,1,2,4,4,1,3,1,2,10,2,2,5,5,2,3,2,3,3,2,2,3,3,3,3,2,3,3,3,3,4,2,3,3,3,4,4,3,2,3,1,3,5,2,3,3,3,3,2,3,3,4,2,2,3,3,3,3,3,3,3,4,2,3,4,4,2,3,4,4,3,1,3,4,2,3,4,3,2,2,2,2,2,2,2,2,2,2,2,2,2,2,2,2,2,1,1,4,3,3,2,4,4,3,2,3,2,5,5,2
28,2,4,2,4,0,0,1,2,4,3,2,4,1,3,10,2,2,2,1,1,2,2,3,2,3,2,3,1,2,3,3,1,1,2,3,2,2,2,2,2,2,3,3,2,2,2,2,2,1,2,2,1,3,2,2,4,3,3,2,2,2,5,5,1,1,1,1,1,1,2,2,2,2,3,4,2,2,1,3,4,3,3,4,4,4,2,1,2,1,2,1,1,1,1,1,1,1,2,2,1,1,1,2,1,2,3,5,4,2,3,4,2,5,4,4
29,1,2,1,1,2,0,1,1,2,1,3,1,2,3,10,2,2,2,2,3,2,4,3,3,2,3,4,4,1,3,2,4,2,3,3,3,2,2,2,4,3,1,4,1,3,1,2,3,1,1,1,2,1,1,1,3,3,4,4,3,4,3,4,2,2,5,5,4,1,4,3,1,5,3,1,1,1,3,3,1,5,3,3,2,2,1,1,2,1,1,2,1,1,1,1,1,1,1,2,2,2,2,2,4,3,3,2,1,3,4,3,1,5,5,3
30,1,2,1,1,1,3,2,2,2,1,3,3,2,1,10,2,2,1,1,1,1,1,4,2,4,3,3,1,3,3,3,2,2,1,3,2,2,2,3,4,3,3,2,2,2,1,4,3,2,3,3,3,4,4,5,5,4,3,5,2,2,2,2,1,1,1,1,1,1,1,1,1,1,1,3,2,3,3,4,3,5,3,3,2,2,2,1,1,1,1,1,1,1,1,1,1,1,1,1,1,1,1,1,1,1,1,3,4,2,2,3,2,4,4,2
31,1,2,1,1,1,2,1,1,4,1,3,1,2,3,10,1,1,2,2,1,1,1,3,5,4,4,2,4,2,4,3,3,3,4,4,3,2,5,4,5,3,3,3,2,3,2,2,5,2,4,1,4,4,1,2,2,5,4,4,3,4,4,3,1,5,3,2,5,4,5,4,3,5,4,4,4,4,5,4,4,4,1,1,2,1,2,2,2,1,2,2,1,1,2,1,1,2,2,2,2,1,1,3,2,3,3,4,4,4,4,4,3,3,3,1
32,1,1,1,2,0,0,2,2,3,2,3,2,2,2,10,2,1,2,2,3,1,3,1,1,2,3,2,3,2,3,4,5,2,2,4,2,1,4,1,2,1,2,1,1,3,1,1,2,1,1,1,1,3,4,2,4,5,5,2,5,2,3,5,1,3,2,4,5,2,4,3,3,5,5,4,5,5,5,5,4,5,5,3,5,5,2,1,2,1,2,2,1,1,2,1,1,2,2,1,1,1,1,4,2,4,4,2,3,2,2,4,2,4,4,2
33,1,3,1,2,0,0,2,2,4,2,1,3,1,2,10,2,2,4,4,2,3,2,2,2,5,2,5,5,3,5,5,3,5,4,5,5,2,3,1,3,5,4,5,3,5,4,2,5,1,5,2,3,2,3,4,1,5,4,3,2,4,3,2,1,3,5,5,5,5,5,3,2,5,5,5,5,3,5,5,5,4,5,2,3,1,2,2,2,1,1,2,2,1,2,1,1,2,2,2,2,1,1,5,3,3,5,4,3,2,5,2,3,5,4,3
34,1,2,1,1,1,2,2,2,1,3,2,2,3,2,10,1,1,3,2,1,3,4,1,1,1,1,1,1,2,1,1,3,2,2,2,2,2,3,1,1,2,3,2,5,5,2,1,2,1,1,1,2,2,2,1,2,1,2,1,1,3,3,3,1,1,2,2,2,4,3,1,1,3,4,3,5,2,2,1,2,5,5,1,5,5,2,2,2,2,2,2,1,2,2,1,1,1,2,2,1,1,1,3,2,2,2,4,4,2,4,3,3,2,2,2
35,1,3,2,2,0,0,1,2,3,2,2,1,1,4,10,2,2,3,2,2,1,5,2,1,1,1,2,2,2,5,2,5,2,5,1,5,1,5,3,2,3,3,3,3,5,1,1,1,3,1,1,1,1,1,1,4,4,4,5,3,2,2,2,1,1,3,3,5,5,3,4,4,5,4,4,4,3,5,5,3,4,5,1,5,5,2,2,2,1,2,2,2,2,2,1,1,2,2,2,1,2,1,3,1,3,5,4,4,2,3,4,2,4,5,2
36,2,1,1,2,0,0,2,1,3,2,2,4,1,2,10,1,1,5,1,4,5,5,5,3,4,4,5,2,5,5,5,3,3,5,2,5,4,4,5,4,2,3,3,3,5,2,5,1,5,5,5,3,3,1,5,4,5,5,5,5,5,2,3,3,5,4,4,2,4,4,5,5,2,2,5,5,2,5,5,5,5,5,5,1,3,2,2,2,2,1,1,1,1,2,1,1,1,2,2,1,2,1,5,2,3,1,5,5,1,3,3,4,5,5,2
37,1,4,1,1,2,0,2,2,4,3,1,4,1,3,10,2,1,3,5,2,5,2,5,1,3,1,2,3,4,5,5,5,4,3,2,5,5,3,2,1,2,3,1,1,4,1,4,5,3,1,2,4,3,1,1,3,5,5,4,3,5,5,5,1,3,5,5,5,5,4,3,3,2,4,5,2,1,3,3,2,5,3,3,5,5,1,2,2,1,1,2,1,1,1,2,1,2,2,1,1,1,1,2,2,3,3,4,3,2,2,4,2,5,5,3
38,1,2,3,1,1,3,2,2,2,1,3,4,2,3,10,1,2,2,2,2,2,3,4,1,2,2,5,2,1,3,3,2,3,2,3,2,2,4,4,4,4,2,2,2,2,2,3,3,2,2,2,2,2,2,2,3,2,2,3,3,3,3,3,3,3,3,3,3,3,2,3,3,3,3,3,3,3,3,3,3,3,3,2,3,3,1,1,2,1,1,1,1,2,1,1,1,1,1,1,1,1,1,2,2,2,3,2,2,3,1,3,2,1,1,3
39,1,2,1,1,1,1,1,1,3,2,2,1,1,2,10,1,2,4,5,2,5,4,4,2,3,4,1,1,5,5,4,4,3,2,4,2,2,5,4,3,3,5,2,2,2,2,3,4,2,4,1,3,3,2,1,4,2,1,4,1,3,3,3,3,3,3,4,5,1,5,3,5,5,3,3,5,1,3,3,2,5,5,5,1,1,1,2,2,2,1,2,2,1,2,1,1,2,2,2,1,2,1,5,4,5,4,4,3,3,3,5,3,4,3,5
40,2,2,1,1,2,0,2,2,3,2,2,3,1,2,10,1,2,5,4,2,2,1,1,1,5,2,3,5,3,1,1,1,4,2,4,2,3,3,5,3,2,2,4,2,5,3,4,3,2,3,2,2,2,2,3,2,4,4,4,3,4,4,4,2,4,3,4,3,3,4,4,4,3,4,4,4,3,4,4,4,4,3,2,2,2,2,2,2,2,1,2,2,1,2,2,1,2,2,1,1,1,1,2,2,3,4,4,4,3,4,3,2,5,5,2
41,1,3,1,1,1,2,2,1,3,2,2,2,1,1,10,2,1,3,3,2,3,2,4,2,4,4,3,3,3,2,4,4,3,3,2,3,2,2,1,2,3,3,3,3,4,2,2,2,2,3,2,4,3,2,3,2,3,4,4,2,4,4,4,2,3,4,4,4,4,3,2,4,4,3,5,3,2,4,4,3,4,2,2,2,2,2,1,2,1,1,2,1,1,2,1,1,2,2,2,2,2,1,4,4,4,4,3,4,3,2,3,3,3,4,2
42,2,1,1,2,0,0,1,1,4,3,1,3,1,2,10,2,2,3,3,3,2,1,1,3,2,2,3,3,3,3,1,3,3,3,3,3,2,2,2,3,3,2,3,1,3,2,2,2,4,1,1,1,1,1,2,2,2,2,3,2,2,3,3,4,2,1,1,3,2,2,3,3,3,3,3,3,4,4,2,2,2,3,4,3,3,2,1,1,1,2,2,2,2,2,1,1,2,2,2,2,1,2,2,1,3,3,4,4,3,3,3,1,4,5,3
43,1,4,1,1,2,0,2,2,4,3,2,4,1,1,10,2,2,5,5,5,5,3,3,2,3,3,4,5,4,2,4,3,3,3,5,4,2,5,3,2,5,4,4,3,5,5,3,3,3,3,2,2,2,1,3,3,3,3,3,3,3,5,3,1,1,3,1,5,5,3,3,3,5,3,3,3,3,5,3,3,5,3,4,2,2,2,2,1,1,2,2,2,2,2,1,1,2,2,2,2,1,1,2,3,3,4,4,4,4,2,4,3,5,5,3
44,2,2,1,1,1,2,1,2,3,2,2,2,1,4,10,1,1,3,2,1,3,3,3,1,3,3,5,5,5,3,1,5,5,4,2,1,3,5,1,3,1,3,3,3,3,1,2,3,1,1,1,3,4,2,2,2,4,4,3,2,4,3,3,5,4,2,4,1,5,5,1,3,5,4,5,3,3,3,4,4,4,4,3,2,1,2,1,1,1,1,2,1,2,2,1,1,1,2,1,2,1,1,4,5,3,1,5,4,5,4,2,1,5,5,2
45,1,2,1,1,1,2,2,2,5,2,2,1,1,2,10,1,1,2,2,1,4,3,5,4,5,3,1,4,2,4,2,4,4,3,5,3,1,3,1,3,1,2,3,2,5,2,3,4,1,3,3,3,3,2,5,5,3,2,3,3,2,4,3,1,3,3,4,5,4,4,3,3,3,3,4,2,3,3,3,5,1,1,1,1,3,1,1,1,1,1,2,1,1,2,1,1,2,2,2,2,1,1,3,4,4,4,4,5,2,4,4,3,4,5,4
46,2,1,1,2,0,0,1,2,4,3,1,3,1,3,10,2,2,3,3,2,3,3,4,2,3,4,4,4,3,3,3,1,2,3,3,2,2,4,2,2,2,2,2,1,3,4,3,2,3,4,4,4,4,2,2,2,4,4,4,3,1,2,4,3,4,4,4,3,2,4,2,3,3,4,4,3,2,4,3,3,4,4,2,2,1,2,2,1,1,2,2,2,1,1,2,1,2,2,2,2,1,1,4,3,5,4,4,4,5,3,4,5,5,5,4
47,1,2,1,1,1,2,1,1,4,3,1,2,1,3,10,1,1,3,3,2,3,5,5,4,3,4,2,4,4,4,3,5,3,2,2,3,5,3,1,5,3,4,4,3,4,1,2,5,2,3,1,5,4,2,3,2,2,3,4,3,3,2,2,3,3,2,2,1,4,2,3,4,2,4,4,2,2,5,5,4,5,1,4,1,2,2,1,2,1,1,2,1,2,2,1,2,1,1,1,1,2,2,2,4,4,5,4,2,2,3,4,3,3,3,3
48,1,2,1,1,2,0,1,1,1,1,3,4,2,2,10,2,2,2,3,2,5,3,4,5,2,1,2,2,2,4,2,3,2,1,1,2,2,4,1,3,1,2,3,2,2,1,2,2,1,5,3,2,5,1,2,1,4,4,2,3,3,4,3,1,1,1,2,4,3,5,3,4,1,4,3,4,1,4,4,2,3,5,2,1,4,2,2,2,1,1,1,1,1,2,1,1,1,1,1,1,1,1,1,1,1,5,5,3,3,3,2,1,5,4,4
49,1,2,1,1,1,1,2,2,1,1,3,3,2,3,10,1,1,4,4,5,5,4,3,2,2,3,1,1,4,2,5,3,5,3,2,3,3,1,1,3,3,3,4,3,5,1,2,4,3,4,3,5,4,2,3,3,3,5,2,2,4,4,4,2,2,4,4,3,4,5,5,3,3,4,5,3,2,4,4,2,5,3,2,2,2,2,2,2,2,2,2,1,1,1,1,1,2,1,1,2,1,1,3,2,2,2,4,3,2,3,2,3,4,4,2
50,2,3,1,2,0,0,2,2,4,4,1,3,1,2,10,2,2,3,4,3,2,2,3,1,3,5,2,1,4,2,2,2,3,2,2,1,2,2,2,2,2,4,2,4,5,2,3,4,2,3,2,4,3,2,1,3,3,4,3,3,4,3,3,3,4,3,2,3,4,4,5,4,4,2,5,3,4,5,5,2,4,1,1,2,3,2,1,2,1,2,2,1,1,2,1,1,1,2,1,1,1,1,4,2,4,2,4,3,2,1,3,4,4,3,2
51,1,1,2,2,0,0,2,1,3,4,2,1,1,2,10,1,1,1,3,2,1,2,1,1,2,3,1,2,3,2,3,4,3,2,5,2,2,1,4,5,2,3,2,3,3,1,3,2,2,1,2,1,3,2,3,4,3,4,4,5,5,3,2,2,1,3,5,1,2,3,2,3,1,3,4,5,2,3,2,1,4,3,2,2,3,2,2,2,1,1,2,1,2,2,1,1,1,1,2,2,1,1,4,4,2,2,4,3,1,3,1,4,4,5,2
52,1,3,1,3,0,0,2,2,5,2,2,4,1,1,10,2,2,3,3,2,2,3,3,3,2,2,3,3,3,4,3,3,3,2,3,2,1,2,1,3,2,3,3,3,3,2,2,4,1,1,2,2,2,5,2,4,3,3,3,2,5,4,4,2,3,4,5,4,3,5,3,2,2,3,3,3,4,4,5,2,4,1,1,1,1,2,2,2,1,2,2,1,1,2,1,2,2,2,2,2,2,1,2,3,2,2,3,2,2,4,4,3,4,4,3
53,1,2,1,1,1,2,1,2,1,1,3,2,2,2,10,1,1,3,3,2,2,3,3,3,4,2,2,3,3,4,4,3,3,2,3,5,1,2,1,3,2,3,2,2,4,4,2,4,1,1,2,2,3,2,2,4,3,3,3,2,5,4,4,2,3,4,4,4,3,5,3,2,2,3,3,3,3,4,4,3,4,1,1,1,2,1,1,2,1,2,2,1,1,2,1,2,2,2,2,1,2,1,2,2,2,2,3,2,2,4,4,3,4,5,3
54,1,4,1,1,2,0,2,1,3,4,2,2,1,3,10,2,2,5,4,3,4,2,5,1,3,2,2,5,3,4,3,1,2,3,2,2,1,4,1,3,1,1,3,3,1,1,2,2,1,4,1,1,1,1,1,1,3,1,3,3,2,1,1,1,3,3,2,2,1,4,1,1,1,1,2,3,2,3,3,3,4,4,3,2,2,1,1,1,1,1,1,2,2,1,1,1,2,2,1,1,1,1,2,4,3,3,4,3,3,4,3,2,5,4,4
55,2,2,3,1,1,2,2,2,4,2,2,1,1,2,10,2,2,2,2,2,3,3,5,4,3,4,2,4,2,3,4,1,2,3,4,2,1,1,2,3,1,1,3,3,3,2,2,3,1,1,1,1,1,1,3,3,3,2,3,3,4,4,3,1,3,3,4,4,1,5,3,4,1,2,3,3,2,3,3,3,2,4,3,3,2,1,1,1,2,1,1,2,2,2,1,1,2,2,2,1,1,1,3,4,4,3,4,4,3,4,3,2,4,5,3
56,1,1,1,2,0,0,1,2,3,4,2,4,1,4,10,2,1,4,4,3,2,1,1,1,1,1,1,1,1,3,1,2,2,5,2,3,2,1,2,4,1,2,2,3,3,2,1,2,2,2,3,2,2,3,2,2,3,3,3,4,5,4,3,2,2,2,3,2,3,5,4,1,2,3,2,4,4,3,4,2,3,3,4,5,5,1,1,2,1,1,1,1,1,1,1,1,1,1,1,1,2,1,1,1,1,1,1,1,1,3,4,1,5,5,3
57,2,3,1,2,0,0,2,2,3,2,2,2,1,3,10,1,1,5,5,2,3,2,3,3,2,2,3,3,3,3,2,3,3,3,3,4,2,3,3,3,4,4,3,2,3,1,3,5,2,3,3,3,3,2,3,3,4,2,2,3,3,3,3,3,3,3,4,2,3,4,4,2,3,4,4,3,1,3,4,2,3,4,3,2,2,2,2,2,2,2,2,2,2,2,2,2,2,2,2,2,1,1,4,3,2,2,4,4,2,2,3,2,5,5,2
58,1,2,1,1,1,2,1,1,4,4,1,1,1,3,10,1,1,2,1,1,2,2,3,2,3,2,3,1,2,3,3,1,1,2,3,2,2,2,2,2,4,3,3,2,2,2,2,2,1,2,2,1,3,2,2,4,3,3,2,2,2,5,5,1,1,1,1,1,1,2,2,2,2,3,4,2,2,1,3,4,3,3,4,4,4,2,1,2,1,2,1,1,1,1,1,1,1,2,2,1,1,1,2,1,2,3,5,4,2,3,4,2,5,4,4
59,1,4,1,3,0,0,2,2,1,1,3,3,2,1,10,2,2,2,2,3,2,4,3,3,2,3,4,4,1,3,2,4,2,3,3,3,2,2,2,4,3,1,4,1,3,1,2,3,1,1,1,2,1,1,1,3,3,4,4,3,4,3,4,2,2,5,5,4,1,4,3,1,5,3,1,1,1,3,3,1,5,3,3,2,2,1,1,2,1,1,2,1,1,1,1,1,1,1,2,2,2,2,2,4,3,3,2,1,3,4,3,1,5,5,3
60,1,1,1,2,0,0,1,1,4,2,2,3,3,2,10,1,1,1,1,1,1,1,4,2,4,3,3,3,3,3,3,2,2,1,3,2,2,2,3,4,3,3,2,2,2,1,4,3,2,3,3,3,4,4,5,5,4,3,5,2,2,2,2,1,1,1,1,1,1,1,1,1,1,1,3,2,3,3,4,3,5,3,3,2,2,2,1,1,1,1,1,1,1,1,1,1,1,1,1,1,1,1,1,1,1,1,3,4,2,2,3,2,4,4,2
61,1,2,1,1,1,2,2,2,3,3,2,2,1,2,10,2,2,2,2,1,1,1,3,5,4,4,2,4,2,4,3,3,1,4,4,3,2,5,4,5,3,3,3,2,3,2,2,5,2,4,1,4,4,1,2,2,5,4,4,3,4,4,3,1,5,3,2,5,4,5,4,3,5,4,4,4,4,5,4,4,4,1,1,2,1,2,2,2,1,2,2,1,1,2,1,1,2,2,2,2,1,1,3,3,2,3,4,4,4,4,4,3,3,3,1
62,1,3,1,2,0,0,1,1,1,1,3,1,2,4,10,2,2,2,2,3,1,3,1,1,2,3,2,1,2,3,4,5,2,2,4,2,1,4,1,2,1,2,1,1,3,1,1,2,1,1,1,1,3,4,2,4,5,5,2,5,2,3,5,1,3,2,4,5,2,4,3,3,5,5,4,5,5,5,5,4,5,5,3,5,5,2,1,2,1,2,2,1,1,2,1,1,2,2,1,1,1,1,4,2,4,4,2,3,2,2,4,2,4,4,2
63,2,2,1,1,1,2,2,2,4,3,1,4,1,3,10,2,2,4,4,2,3,2,2,2,5,2,5,5,3,5,5,3,5,4,5,5,2,3,1,1,5,4,5,3,5,4,2,5,1,5,2,3,2,3,4,1,5,4,3,2,4,3,2,1,3,5,5,5,5,5,3,2,5,5,5,5,3,5,5,5,4,5,2,3,1,2,2,2,1,1,2,2,1,2,1,1,2,2,2,2,1,1,5,2,3,5,4,3,3,5,2,3,5,4,3
64,1,4,1,4,0,0,2,1,5,4,2,3,1,1,10,1,1,3,2,1,3,4,1,1,1,1,1,1,2,1,1,3,2,2,2,2,2,3,1,3,2,3,2,5,5,4,1,2,1,1,1,2,2,2,1,2,1,2,1,1,3,3,3,1,1,2,2,2,4,3,1,1,3,4,3,5,2,2,1,2,5,5,1,5,5,2,2,2,2,2,2,1,2,2,1,1,1,2,2,1,1,1,3,2,2,2,4,4,3,4,3,3,2,2,2
65,1,3,1,2,0,0,1,2,4,3,1,2,1,2,10,1,1,3,2,2,1,5,2,1,1,1,2,2,2,5,2,5,2,5,1,5,1,5,3,2,3,3,3,3,5,1,1,1,3,1,1,1,1,1,1,4,4,4,5,3,2,2,2,1,1,3,3,5,5,3,4,4,5,4,4,4,3,5,5,3,4,5,1,5,5,2,2,2,1,2,2,2,2,2,1,1,2,2,2,1,2,1,2,1,3,5,4,4,3,3,4,2,4,5,2
66,1,1,2,2,0,0,2,2,2,1,3,1,2,2,10,1,1,5,1,4,5,5,5,3,4,4,5,2,5,5,5,3,3,5,2,5,4,4,5,4,2,3,3,3,5,2,5,1,5,5,5,3,3,1,5,4,5,5,5,5,5,2,3,3,5,4,4,2,4,4,5,5,2,2,5,5,2,5,5,5,5,5,5,1,3,2,2,2,2,1,1,1,1,2,1,1,1,2,2,1,2,1,5,2,3,1,5,5,1,3,3,4,5,5,2
67,1,2,1,1,2,0,1,2,3,2,2,3,1,4,10,2,2,3,5,2,5,2,5,1,3,1,2,3,4,5,5,5,4,3,2,5,5,3,2,1,2,3,1,1,4,1,4,5,3,1,2,4,3,1,1,3,5,5,4,3,5,5,5,1,3,5,5,5,5,4,3,3,2,4,5,2,1,3,3,2,5,3,3,5,5,1,2,2,1,1,2,1,1,1,2,1,2,2,1,1,1,1,3,2,2,3,4,3,2,2,4,2,5,5,3
68,1,4,1,1,1,2,1,2,1,1,3,3,2,2,10,2,2,2,2,2,2,3,4,1,2,2,5,2,1,3,3,2,3,2,3,2,2,4,4,4,2,2,2,2,2,2,3,3,2,2,2,2,2,2,2,3,2,2,3,3,3,3,3,3,3,3,3,3,3,2,3,3,3,3,3,3,3,3,3,3,3,3,2,3,3,1,1,2,1,1,1,1,2,1,1,1,1,1,1,1,1,1,2,2,2,3,2,2,3,1,3,2,1,1,3
69,1,3,3,2,0,0,2,1,3,3,2,4,3,2,10,1,1,4,5,2,5,4,4,2,3,4,1,3,5,5,1,4,3,2,4,2,2,5,4,1,3,5,2,2,2,2,3,4,2,4,1,3,3,2,1,4,2,1,4,1,3,3,3,3,3,3,4,5,1,5,3,5,5,3,3,5,1,3,3,2,5,5,5,1,1,1,2,2,2,1,2,2,1,2,1,1,2,2,2,1,2,1,5,4,5,4,4,3,2,3,5,3,4,3,5
70,2,2,1,1,1,2,1,1,3,2,2,1,1,1,10,2,1,5,4,2,2,1,1,1,5,2,3,5,3,1,4,1,4,2,4,2,3,3,5,3,2,2,4,2,5,3,4,3,2,3,2,2,2,2,3,2,4,4,4,3,4,4,4,2,4,3,4,3,3,4,4,4,3,4,4,4,3,4,4,4,4,3,2,2,2,2,2,2,2,1,2,2,1,2,2,1,2,2,1,1,1,1,2,2,3,4,4,4,2,4,3,2,5,5,2
71,1,4,2,3,0,0,2,2,5,2,2,2,1,3,10,1,1,3,3,2,3,2,4,2,4,4,3,3,3,2,1,4,3,3,2,3,2,2,1,2,3,3,3,3,4,2,2,2,2,3,2,4,3,2,3,2,3,4,4,2,4,4,4,2,3,4,4,4,4,3,2,4,4,3,5,3,2,4,4,3,4,2,2,2,2,2,1,2,1,1,2,1,1,2,1,1,2,2,2,2,2,1,4,4,4,4,3,4,3,4,3,3,3,4,2
72,1,3,1,2,0,0,1,2,3,2,2,4,1,2,10,2,2,3,3,3,2,1,1,3,2,2,3,3,3,3,4,3,3,3,3,3,2,2,2,3,3,2,3,1,3,2,2,2,4,1,1,1,1,1,2,2,2,2,3,2,2,3,3,4,2,1,1,3,2,2,3,3,3,3,3,3,4,4,2,2,2,3,4,3,3,2,1,1,1,2,2,2,2,2,1,1,2,2,2,2,1,2,2,1,2,3,4,4,2,3,3,1,4,5,3
73,2,1,1,2,0,0,1,2,3,4,2,1,3,2,10,1,1,5,5,5,5,3,3,2,3,3,4,5,4,2,4,3,1,3,5,4,2,5,3,2,5,4,4,3,5,5,3,3,3,3,2,2,2,1,3,3,3,3,3,3,3,5,3,1,1,3,1,5,5,3,3,3,5,3,3,3,3,5,3,3,5,3,4,2,2,2,2,1,1,2,2,2,2,2,1,1,2,2,2,2,1,1,2,3,3,4,4,4,4,2,4,3,5,5,3
74,1,4,1,1,2,0,2,2,3,2,2,3,1,3,10,2,2,3,2,1,3,3,3,1,3,3,5,5,5,3,1,5,5,4,2,1,3,5,1,3,1,3,3,3,3,1,2,3,1,1,1,3,4,2,2,2,4,4,3,2,4,3,3,5,4,2,4,1,5,5,1,3,5,4,5,3,3,3,4,4,4,4,3,2,1,2,1,1,1,1,2,1,2,2,1,1,1,2,1,2,1,1,4,5,2,1,5,4,5,2,2,1,5,5,2
75,1,2,3,1,1,2,2,1,1,1,3,2,2,3,10,1,1,2,2,1,4,3,5,4,5,3,1,4,2,4,2,4,4,3,5,3,1,3,1,3,1,2,3,2,5,2,3,4,1,3,3,3,3,2,5,5,3,2,3,3,2,4,3,1,3,3,4,5,4,4,3,3,3,3,4,2,3,3,3,5,1,1,1,1,3,1,1,1,1,1,2,1,1,2,1,1,2,2,2,2,1,1,3,4,4,4,4,5,2,2,4,3,4,5,4
76,1,4,1,3,0,0,2,2,3,3,2,1,1,2,10,1,1,3,3,2,3,3,4,2,3,4,4,4,3,3,3,1,2,3,3,2,2,4,2,2,2,2,2,1,3,2,3,2,3,4,4,4,4,2,2,2,4,4,4,3,1,2,4,3,4,4,4,3,2,4,2,3,3,4,4,3,2,4,3,3,4,4,2,2,1,2,2,1,1,2,2,2,1,1,2,1,2,2,2,2,1,1,4,3,5,4,4,4,5,3,4,5,5,5,4
77,2,3,1,2,0,0,1,1,3,2,2,4,1,1,10,2,2,3,3,2,3,5,5,4,3,4,2,4,4,4,3,5,3,2,2,3,5,3,1,5,3,4,4,3,4,1,2,5,2,3,1,5,4,2,3,2,2,3,4,3,3,2,2,3,3,2,2,1,4,2,3,4,2,4,4,2,2,5,5,4,5,1,4,1,2,2,1,2,1,1,2,1,2,2,1,2,1,1,1,1,2,2,2,4,4,5,4,2,2,3,4,3,3,3,3
78,1,1,1,2,0,0,2,2,3,2,2,3,1,2,10,1,1,2,3,2,5,3,4,5,2,1,2,2,2,4,2,3,2,2,1,2,2,4,1,3,1,2,3,2,2,1,2,2,1,5,3,2,5,1,2,1,4,4,2,3,3,4,3,1,1,1,2,4,3,5,3,4,1,4,3,4,1,4,4,2,3,5,2,1,4,2,2,2,1,1,1,1,1,2,1,1,1,1,1,1,1,1,1,1,1,5,5,3,3,3,2,1,5,4,4
79,1,3,2,2,0,0,2,2,1,1,3,3,2,4,10,2,2,4,4,5,5,4,3,2,2,3,1,1,4,2,5,3,5,3,2,3,3,1,1,3,3,3,4,3,5,1,2,4,3,4,3,5,4,2,3,3,3,5,2,2,4,4,4,2,2,4,4,3,4,5,5,3,3,4,5,3,2,4,4,2,5,3,2,2,2,2,2,2,2,2,2,1,1,1,1,1,2,1,1,2,1,1,3,2,3,2,4,3,3,3,2,3,4,4,2
80,1,2,1,1,1,1,1,1,3,3,2,4,1,2,10,1,1,3,4,3,2,2,3,1,3,5,2,3,4,2,2,2,3,1,2,1,2,2,2,2,2,4,2,4,5,4,3,4,2,3,2,4,3,2,1,3,3,4,3,3,4,3,3,3,4,3,2,3,4,4,5,4,4,2,5,3,4,5,5,2,4,1,1,2,3,2,1,2,1,2,2,1,1,2,1,1,1,2,1,1,1,1,4,2,4,2,4,3,2,1,3,4,4,3,2
81,1,4,1,1,1,2,2,2,2,1,3,1,2,2,10,2,2,1,3,2,1,2,1,1,2,3,1,2,3,2,3,4,3,2,5,2,2,1,4,5,2,3,2,3,3,1,3,2,2,1,2,1,3,2,3,4,3,4,4,5,5,3,2,2,1,3,5,1,2,3,2,3,1,3,4,5,2,3,2,1,4,3,2,2,3,2,2,2,1,1,2,1,2,2,1,1,1,1,2,2,1,1,4,4,3,2,4,3,1,3,1,4,4,5,2
82,1,3,1,2,0,0,2,2,3,4,2,4,1,2,10,1,1,3,3,2,2,3,3,3,2,2,3,3,3,4,3,3,1,2,3,2,1,2,1,3,4,3,3,3,3,2,2,4,1,1,2,2,2,5,2,4,3,3,3,2,5,4,4,2,3,4,5,4,3,5,3,2,2,3,3,3,4,4,5,2,4,1,1,1,1,2,2,2,1,2,2,1,1,2,1,2,2,2,2,2,2,1,3,3,2,2,3,2,2,4,4,3,4,4,3
83,2,2,1,1,1,2,1,1,3,2,2,2,1,3,10,2,2,3,3,2,2,3,3,3,4,2,2,3,3,4,4,3,3,2,3,5,1,2,1,3,2,3,2,2,4,2,2,4,1,1,2,2,3,2,2,4,3,3,3,2,5,4,4,2,3,4,4,4,3,5,3,2,2,3,3,3,3,4,4,3,4,1,1,1,2,1,1,2,1,2,2,1,1,2,1,2,2,2,2,1,2,1,2,3,3,2,3,2,2,4,4,3,4,5,3
84,1,1,3,4,0,0,2,2,3,2,2,2,1,3,10,1,1,5,4,3,4,2,5,1,3,2,2,5,3,4,3,1,2,3,2,2,1,4,1,3,1,1,3,3,1,1,2,2,1,4,1,1,1,1,1,1,3,1,3,3,2,1,1,1,3,3,2,2,1,4,1,1,1,1,2,3,2,3,3,3,4,4,3,2,2,1,1,1,1,1,1,2,2,1,1,1,2,2,1,1,1,1,2,4,2,3,4,3,3,4,3,2,5,4,4
85,1,4,1,1,2,0,2,1,3,3,2,1,1,2,10,2,2,2,2,2,3,3,5,4,3,4,2,4,2,3,4,1,2,3,4,2,1,1,2,3,1,1,3,3,3,2,2,3,1,1,1,1,1,1,3,3,3,2,3,3,4,4,3,1,3,3,4,4,1,5,3,4,1,2,3,3,2,3,3,3,2,4,3,3,2,1,1,1,2,1,1,2,2,2,1,1,2,2,2,1,1,1,2,4,4,3,4,4,2,4,3,2,4,5,3
86,1,3,1,2,0,0,1,2,1,1,3,3,2,2,10,1,1,4,4,3,2,1,1,1,1,1,1,1,1,3,1,2,2,5,2,3,2,1,2,4,1,2,2,3,3,2,1,2,2,2,3,2,2,3,2,2,3,3,3,4,5,4,3,2,2,2,3,2,3,5,4,1,2,3,2,4,4,3,4,2,3,3,4,5,5,1,1,2,1,1,1,1,1,1,1,1,1,1,1,1,2,1,1,1,1,1,1,1,1,3,4,1,5,5,3
87,1,2,1,1,1,2,2,1,3,4,2,3,1,4,10,2,2,5,5,2,3,2,3,3,2,2,3,1,3,3,2,3,3,3,3,4,2,3,3,3,4,4,3,2,3,1,3,5,2,3,3,3,3,2,3,3,4,2,2,3,3,3,3,3,3,3,4,2,3,4,4,2,3,4,4,3,1,3,4,2,3,4,3,2,2,2,2,2,2,2,2,2,2,2,2,2,2,2,2,2,1,1,4,2,3,2,4,4,3,2,3,2,5,5,2
88,1,3,1,2,0,0,1,2,3,3,2,3,1,1,10,1,1,2,1,1,2,2,3,2,3,2,3,4,2,3,3,1,1,2,3,2,2,2,2,2,2,3,3,2,2,2,2,2,1,2,2,1,3,2,2,4,3,3,2,2,2,5,5,1,1,1,1,1,1,2,2,2,2,3,4,2,2,1,3,4,3,3,4,4,4,2,1,2,1,2,1,1,1,1,1,1,1,2,2,1,1,1,2,1,2,3,5,4,2,3,4,2,5,4,4
89,2,1,2,2,0,0,2,2,3,2,2,1,1,2,10,1,1,2,2,3,2,4,3,3,2,3,4,4,1,3,2,4,2,3,3,3,2,2,2,4,3,1,4,1,3,1,2,3,1,1,1,2,1,1,1,3,3,4,4,3,4,3,4,2,2,5,5,4,1,4,3,1,5,3,1,1,1,3,3,1,5,3,3,2,2,1,1,2,1,1,2,1,1,1,1,1,1,1,2,2,2,2,2,4,3,3,2,1,3,2,3,1,5,5,3
90,2,4,1,3,0,0,1,2,3,2,2,4,1,2,10,1,1,1,1,1,1,1,4,2,4,3,3,3,3,3,3,2,2,1,3,2,2,2,3,4,3,3,2,2,2,1,4,3,2,3,3,3,4,4,5,5,4,3,5,2,2,2,2,1,1,1,1,1,1,1,1,1,1,1,3,2,3,3,4,3,5,3,3,2,2,2,1,1,1,1,1,1,1,1,1,1,1,1,1,1,1,1,1,1,1,1,3,4,2,2,3,2,4,4,2
91,1,3,1,1,1,2,2,1,3,2,2,2,1,2,10,2,2,2,2,1,1,1,3,5,4,4,2,4,2,4,3,3,3,4,4,3,2,5,4,5,3,3,3,2,3,2,2,5,2,4,1,4,4,1,2,2,5,4,4,3,4,4,3,1,5,3,2,5,4,5,4,3,5,4,4,4,4,5,4,4,4,1,1,2,1,2,2,2,1,2,2,1,1,2,1,1,2,2,2,2,1,1,3,2,3,3,4,4,4,4,4,3,3,3,1
92,1,2,1,1,1,2,2,2,3,2,2,4,1,4,10,1,1,2,2,3,1,3,1,1,2,3,2,3,2,3,4,5,2,2,4,2,1,4,1,2,1,2,1,1,3,1,1,2,1,1,1,1,3,4,2,4,5,5,2,5,2,3,5,1,3,2,4,5,2,4,3,3,5,5,4,5,5,5,5,4,5,5,3,5,5,2,1,2,1,2,2,1,1,2,1,1,2,2,1,1,1,1,4,2,4,4,2,3,2,2,4,2,4,4,2
93,2,3,3,4,0,0,1,2,3,2,2,1,1,2,10,1,1,4,4,2,3,2,2,2,5,2,5,5,3,5,5,3,5,4,5,5,2,3,1,1,5,4,5,3,5,4,2,5,1,5,2,3,2,3,4,1,5,4,3,2,4,3,2,1,3,5,5,5,5,5,3,2,5,5,5,5,3,5,5,5,4,5,2,3,1,2,2,2,1,1,2,2,1,2,1,1,2,2,2,2,1,1,5,3,3,5,4,3,3,5,2,3,5,4,3
94,1,1,1,2,0,0,2,2,2,1,3,3,2,3,10,2,2,3,2,1,3,4,1,1,1,1,1,1,2,1,4,3,2,2,2,2,2,3,1,1,4,3,2,5,5,2,1,2,1,1,1,2,2,2,1,2,1,2,1,1,3,3,3,1,1,2,2,2,4,3,1,1,3,4,3,5,2,2,1,2,5,5,1,5,5,2,2,2,2,2,2,1,2,2,1,1,1,2,2,1,1,1,2,2,2,2,4,4,3,4,3,3,2,2,2
95,1,4,1,1,1,2,2,1,3,4,2,3,1,2,10,2,2,3,2,2,1,5,2,1,1,1,2,2,2,5,2,5,2,5,1,5,1,5,3,2,3,3,3,3,5,1,1,1,3,1,1,1,1,1,1,4,4,4,5,3,2,2,2,1,1,3,3,5,5,3,4,4,5,4,4,4,3,5,5,3,4,5,1,5,5,2,2,2,1,2,2,2,2,2,1,1,2,2,2,1,2,1,3,1,3,5,4,4,2,3,4,2,4,5,2
96,2,3,1,1,1,3,1,2,3,2,2,2,3,2,10,1,1,5,1,4,5,5,5,3,4,4,5,2,5,5,5,3,3,5,2,5,4,4,5,4,2,3,3,3,5,2,5,1,5,5,5,3,3,1,5,4,5,5,5,5,5,2,3,3,5,4,4,2,4,4,5,5,2,2,5,5,2,5,5,5,5,5,5,1,3,2,2,2,2,1,1,1,1,2,1,1,1,2,2,1,2,1,5,2,2,1,5,5,1,3,3,4,5,5,2
97,1,2,1,1,1,2,1,2,3,2,2,1,1,1,10,2,2,3,5,2,5,2,5,1,3,1,2,3,4,5,5,5,4,3,2,5,5,3,2,1,2,3,1,1,4,1,4,5,3,1,2,4,3,1,1,3,5,5,4,3,5,5,5,1,3,5,5,5,5,4,3,3,2,4,5,2,1,3,3,2,5,3,3,5,5,1,2,2,1,1,2,1,1,1,2,1,2,2,1,1,1,1,2,2,2,3,4,3,2,2,4,2,5,5,3
98,1,1,2,2,0,0,2,1,4,3,1,4,1,2,10,2,2,2,2,2,2,3,4,1,2,2,5,2,1,3,3,2,3,2,3,2,2,4,4,4,2,2,2,2,2,2,3,3,2,2,2,2,2,2,2,3,2,2,3,3,3,3,3,3,3,3,3,3,3,2,3,3,3,3,3,3,3,3,3,3,3,3,2,3,3,1,1,2,1,1,1,1,2,1,1,1,1,1,1,1,1,1,3,2,2,3,2,2,3,1,3,2,1,1,3
99,1,3,1,1,2,0,1,2,4,2,2,3,1,3,10,1,1,4,5,2,5,4,4,2,3,4,1,3,5,5,4,4,3,2,4,2,2,5,4,3,3,5,2,2,2,2,3,4,2,4,1,3,3,2,1,4,2,1,4,1,3,3,3,3,3,3,4,5,1,5,3,5,5,3,3,5,1,3,3,2,5,5,5,1,1,1,2,2,2,1,2,2,1,2,1,1,2,2,2,1,2,1,5,4,5,4,4,3,3,3,5,3,4,3,5
100,1,2,1,1,1,2,2,2,1,1,3,2,2,1,10,2,2,5,4,2,2,1,1,1,5,2,3,5,3,1,4,1,4,2,4,2,3,3,5,3,2,2,4,2,5,3,4,3,2,3,2,2,2,2,3,2,4,4,4,3,4,4,4,2,4,3,4,3,3,4,4,4,3,4,4,4,3,4,4,4,4,3,2,2,2,2,2,2,2,1,2,2,1,2,2,1,2,2,1,1,1,1,2,2,3,4,4,4,3,4,3,2,5,5,2
101,1,4,1,1,1,2,1,2,3,3,2,1,2,2,10,1,1,3,3,2,3,2,4,2,4,4,3,3,3,2,1,4,1,3,2,3,2,2,1,2,3,3,3,3,4,4,2,2,2,3,2,4,3,2,3,2,3,4,4,2,4,4,4,2,3,4,4,4,4,3,2,4,4,3,5,3,2,4,4,3,4,2,2,2,2,2,1,2,1,1,2,1,1,2,1,1,2,2,2,2,2,1,4,4,4,4,3,4,3,4,3,3,3,4,2
102,2,2,3,1,1,2,1,1,3,2,2,3,1,4,10,2,2,3,3,3,2,1,1,3,2,2,3,3,3,3,4,3,3,3,3,3,2,2,2,3,3,2,3,1,3,2,2,2,4,1,1,1,1,1,2,2,2,2,3,2,2,3,3,4,2,1,1,3,2,2,3,3,3,3,3,3,4,4,2,2,2,3,4,3,3,2,1,1,1,2,2,2,2,2,1,1,2,2,2,2,1,2,2,1,3,3,4,4,3,3,3,1,4,5,3
103,1,1,1,2,0,0,2,2,3,2,2,2,1,3,10,1,1,5,5,5,5,3,3,2,3,3,4,5,4,2,4,3,3,3,5,4,2,5,3,2,5,4,4,3,5,5,3,3,3,3,2,2,2,1,3,3,3,3,3,3,3,5,3,1,1,3,1,5,5,3,3,3,5,3,3,3,3,5,3,3,5,3,4,2,2,2,2,1,1,2,2,2,2,2,1,1,2,2,2,2,1,1,2,3,3,4,4,4,4,2,4,3,5,5,3
104,1,3,1,1,1,2,2,2,4,4,1,3,1,2,10,2,2,3,2,1,3,3,3,1,3,3,5,5,5,3,1,5,5,4,2,1,3,5,1,3,1,3,3,3,3,1,2,3,1,1,1,3,4,2,2,2,4,4,3,2,4,3,3,5,4,2,4,1,5,5,1,3,5,4,5,3,3,3,4,4,4,4,3,2,1,2,1,1,1,1,2,1,2,2,1,1,1,2,1,2,1,1,4,5,3,1,5,4,5,4,2,1,5,5,2
105,1,2,1,1,2,0,2,1,1,1,3,1,2,2,10,1,1,2,2,1,4,3,5,4,5,3,1,1,2,4,2,4,4,3,5,3,1,3,1,3,1,2,3,2,5,2,3,4,1,3,3,3,3,2,5,5,3,2,3,3,2,4,3,1,3,3,4,5,4,4,3,3,3,3,4,2,3,3,3,5,1,1,1,1,3,1,1,1,1,1,2,1,1,2,1,1,2,2,2,2,1,1,3,4,4,4,4,5,2,4,4,3,4,5,4
106,2,2,1,1,1,2,1,2,4,3,1,1,1,3,10,2,2,3,3,2,3,3,4,2,3,4,4,4,3,3,3,1,2,3,3,2,2,4,2,2,4,2,2,1,3,2,3,2,3,4,4,4,4,2,2,2,4,4,4,3,1,2,4,3,4,4,4,3,2,4,2,3,3,4,4,3,2,4,3,3,4,4,2,2,1,2,2,1,1,2,2,2,1,1,2,1,2,2,2,2,1,1,4,2,5,4,4,4,5,3,4,5,5,5,4
107,1,3,1,1,1,3,1,2,4,3,1,3,1,2,10,2,2,3,3,2,3,5,5,4,3,4,2,4,4,4,3,5,3,2,2,3,5,3,1,5,3,4,4,3,4,1,2,5,2,3,1,5,4,2,3,2,2,3,4,3,3,2,2,3,3,2,2,1,4,2,3,4,2,4,4,2,2,5,5,4,5,1,4,1,2,2,1,2,1,1,2,1,2,2,1,2,1,1,1,1,2,2,3,4,4,5,4,2,2,3,4,3,3,3,3
108,2,1,2,2,0,0,2,1,3,2,2,2,1,2,10,1,1,2,3,2,5,3,4,5,2,1,2,2,2,4,2,3,2,2,1,2,2,4,1,3,1,2,3,2,2,1,2,2,1,5,3,2,5,1,2,1,4,4,2,3,3,4,3,1,1,1,2,4,3,5,3,4,1,4,3,4,1,4,4,2,3,5,2,1,4,2,2,2,1,1,1,1,1,2,1,1,1,1,1,1,1,1,1,1,1,5,5,3,3,3,2,1,5,4,4
109,1,5,1,1,1,2,2,2,3,4,2,2,1,3,10,2,2,4,4,5,5,4,3,2,2,3,1,4,4,2,5,3,5,3,2,3,3,1,1,3,3,3,4,3,5,1,2,4,3,4,3,5,4,2,3,3,3,5,2,2,4,4,4,2,2,4,4,3,4,5,5,3,3,4,5,3,2,4,4,2,5,3,2,2,2,2,2,2,2,2,2,1,1,1,1,1,2,1,1,2,1,1,2,3,3,2,4,3,2,3,2,3,4,4,2
110,2,2,3,1,1,2,1,2,4,3,1,4,1,2,10,1,1,3,4,3,2,2,3,1,3,5,2,1,4,2,2,2,3,2,2,1,2,2,2,2,2,4,2,4,5,2,3,4,2,3,2,4,3,2,1,3,3,4,3,3,4,3,3,3,4,3,2,3,4,4,5,4,4,2,5,3,4,5,5,2,4,1,1,2,3,2,1,2,1,2,2,1,1,2,1,1,1,2,1,1,1,1,4,2,4,2,4,3,2,1,3,4,4,3,2
111,1,2,1,1,1,3,2,1,4,4,2,4,1,2,10,2,1,1,3,2,1,2,1,1,2,3,1,2,3,2,3,4,3,2,5,2,2,1,4,5,2,3,2,3,3,1,3,2,2,1,2,1,3,2,3,4,3,4,4,5,5,3,2,2,1,3,5,1,2,3,2,3,1,3,4,5,2,3,2,1,4,3,2,2,3,2,2,2,1,1,2,1,2,2,1,1,1,1,2,2,1,1,4,4,3,2,4,3,1,3,1,4,4,5,2
112,1,3,1,1,1,2,1,1,3,2,2,1,1,2,10,1,1,3,3,2,2,3,3,3,2,2,3,3,3,4,3,3,3,2,3,2,1,2,1,3,2,3,3,3,3,2,2,4,1,1,2,2,2,5,2,4,3,3,3,2,5,4,4,2,3,4,5,4,3,5,3,2,2,3,3,3,4,4,5,2,4,1,1,1,1,2,2,2,1,2,2,1,1,2,1,2,2,2,2,2,2,1,3,2,2,2,3,2,2,4,4,3,4,4,3
113,1,1,1,2,0,0,2,2,1,1,3,3,2,2,10,2,1,3,3,2,2,3,3,3,4,2,2,3,3,4,4,3,3,1,3,5,1,2,1,3,2,3,2,2,4,2,2,4,1,1,2,2,3,2,2,4,3,3,3,2,5,4,4,2,3,4,4,4,3,5,3,2,2,3,3,3,3,4,4,3,4,1,1,1,2,1,1,2,1,2,2,1,1,2,1,2,2,2,2,1,2,1,2,2,2,2,3,2,2,2,4,3,4,5,3
114,1,4,2,1,1,2,1,2,3,3,2,1,1,4,10,2,2,5,4,3,4,2,5,1,3,2,2,5,3,4,1,1,2,3,2,2,1,4,1,3,1,1,3,3,1,1,2,2,1,4,1,1,1,1,1,1,3,1,3,3,2,1,1,1,3,3,2,2,1,4,1,1,1,1,2,3,2,3,3,3,4,4,3,2,2,1,1,1,1,1,1,2,2,1,1,1,2,2,1,1,1,1,2,4,2,3,4,3,3,2,3,2,5,4,4
115,2,2,1,1,1,2,1,1,4,4,1,3,1,3,10,1,1,2,2,2,3,3,5,4,3,4,2,1,2,3,4,1,2,3,4,2,1,1,2,3,1,1,3,3,3,4,2,3,1,1,1,1,1,1,3,3,3,2,3,3,4,4,3,1,3,3,4,4,1,5,3,4,1,2,3,3,2,3,3,3,2,4,3,3,2,1,1,1,2,1,1,2,2,2,1,1,2,2,2,1,1,1,2,4,4,3,4,4,3,4,3,2,4,5,3
116,1,2,1,1,1,2,2,1,3,1,2,2,1,1,10,1,1,4,4,3,2,1,1,1,1,1,1,1,1,3,1,2,2,5,2,3,2,1,2,4,1,2,2,3,3,2,1,2,2,2,3,2,2,3,2,2,3,3,3,4,5,4,3,2,2,2,3,2,3,5,4,1,2,3,2,4,4,3,4,2,3,3,4,5,5,1,1,2,1,1,1,1,1,1,1,1,1,1,1,1,2,1,1,1,1,1,1,1,1,3,4,1,5,5,3
117,1,1,3,2,0,0,1,2,1,1,3,1,2,2,10,2,1,5,5,2,3,2,3,3,2,2,3,3,3,3,2,3,3,3,3,4,2,3,3,3,4,4,3,2,3,1,3,5,2,3,3,3,3,2,3,3,4,2,2,3,3,3,3,3,3,3,4,2,3,4,4,2,3,4,4,3,1,3,4,2,3,4,3,2,2,2,2,2,2,2,2,2,2,2,2,2,2,2,2,2,1,1,4,3,3,2,4,4,3,2,3,2,5,5,2
118,2,2,1,1,1,2,2,2,4,4,1,4,1,2,10,1,2,2,1,1,2,2,3,2,3,2,3,4,2,3,3,1,1,2,3,2,2,2,2,2,2,3,3,2,2,2,2,2,1,2,2,1,3,2,2,4,3,3,2,2,2,5,5,1,1,1,1,1,1,2,2,2,2,3,4,2,2,1,3,4,3,3,4,4,4,2,1,2,1,2,1,1,1,1,1,1,1,2,2,1,1,1,2,1,2,3,5,4,2,3,4,2,5,4,4
119,2,3,1,4,0,0,2,2,4,2,2,2,1,4,10,2,1,2,2,3,2,4,3,3,2,3,4,4,1,3,2,4,2,3,3,3,2,2,2,4,3,1,4,1,3,1,2,3,1,1,1,2,1,1,1,3,3,4,4,3,4,3,4,2,2,5,5,4,1,4,3,1,5,3,1,1,1,3,3,1,5,3,3,2,2,1,1,2,1,1,2,1,1,1,1,1,1,1,2,2,2,2,2,4,3,3,2,1,3,4,3,1,5,5,3
120,2,2,2,1,1,2,1,1,3,2,2,1,3,2,10,2,2,1,1,1,1,1,4,2,4,3,3,3,3,3,3,2,2,1,3,2,2,2,3,4,3,3,2,2,2,1,4,3,2,3,3,3,4,4,5,5,4,3,5,2,2,2,2,1,1,1,1,1,1,1,1,1,1,1,3,2,3,3,4,3,5,3,3,2,2,2,1,1,1,1,1,1,1,1,1,1,1,1,1,1,1,1,1,1,1,1,3,4,2,2,3,2,4,4,2
121,1,1,1,2,0,0,1,1,4,4,1,1,1,3,10,1,2,2,2,1,1,1,3,5,4,4,2,4,2,4,3,3,3,4,4,3,2,5,4,5,3,3,3,2,3,2,2,5,2,4,1,4,4,1,2,2,5,4,4,3,4,4,3,1,5,3,2,5,4,5,4,3,5,4,4,4,4,5,4,4,4,1,1,2,1,2,2,2,1,2,2,1,1,2,1,1,2,2,2,2,1,1,3,3,3,3,4,4,4,4,4,3,3,3,1
122,1,2,1,2,0,0,2,2,2,1,3,4,2,3,10,2,1,2,2,3,1,3,1,1,2,3,2,3,2,3,4,5,2,2,4,2,1,4,1,2,1,2,1,1,3,1,1,2,1,1,1,1,3,4,2,4,5,5,2,5,2,3,5,1,3,2,4,5,2,4,3,3,5,5,4,5,5,5,5,4,5,5,3,5,5,2,1,2,1,2,2,1,1,2,1,1,2,2,1,1,1,1,4,2,4,4,2,3,2,2,4,2,4,4,2
123,2,2,1,1,2,0,1,2,3,2,2,1,1,1,10,2,2,4,4,2,3,2,2,2,5,2,5,5,3,5,5,3,5,4,5,5,2,3,1,3,5,4,5,3,5,4,2,5,1,5,2,3,2,3,4,1,5,4,3,2,4,3,2,1,3,5,5,5,5,5,3,2,5,5,5,5,3,5,5,5,4,5,2,3,1,2,2,2,1,1,2,2,1,2,1,1,2,2,2,2,1,1,5,3,3,5,4,3,3,5,2,3,5,4,3
124,1,2,2,1,1,2,1,1,3,2,2,2,1,2,10,1,1,3,2,1,3,4,1,1,1,1,1,1,2,1,1,3,2,2,2,2,2,3,1,3,2,3,2,5,5,2,1,2,1,1,1,2,2,2,1,2,1,2,1,1,3,3,3,1,1,2,2,2,4,3,1,1,3,4,3,5,2,2,1,2,5,5,1,5,5,2,2,2,2,2,2,1,2,2,1,1,1,2,2,1,1,1,3,2,2,2,4,4,3,4,3,3,2,2,2
125,2,1,1,2,0,0,2,1,4,4,1,1,1,4,10,2,2,3,2,2,1,5,2,1,1,1,2,2,2,5,2,5,2,5,1,5,1,5,3,2,3,3,3,3,5,1,1,1,3,1,1,1,1,1,1,4,4,4,5,3,2,2,2,1,1,3,3,5,5,3,4,4,5,4,4,4,3,5,5,3,4,5,1,5,5,2,2,2,1,2,2,2,2,2,1,1,2,2,2,1,2,1,3,1,3,5,4,4,3,3,4,2,4,5,2
126,1,3,1,1,1,2,2,2,4,2,2,3,1,3,10,1,1,5,1,4,5,5,5,3,4,4,5,2,5,5,5,3,3,5,2,5,4,4,5,4,4,3,3,3,5,2,5,1,5,5,5,3,3,1,5,4,5,5,5,5,5,2,3,3,5,4,4,2,4,4,5,5,2,2,5,5,2,5,5,5,5,5,5,1,3,2,2,2,2,1,1,1,1,2,1,1,1,2,2,1,2,1,5,2,2,1,5,5,1,3,3,4,5,5,2
127,2,2,1,1,1,2,1,2,3,2,2,1,1,3,10,2,2,3,5,2,5,2,5,1,3,1,2,1,4,5,5,5,4,3,2,5,5,3,2,1,2,3,1,1,4,1,4,5,3,1,2,4,3,1,1,3,5,5,4,3,5,5,5,1,3,5,5,5,5,4,3,3,2,4,5,2,1,3,3,2,5,3,3,5,5,1,2,2,1,1,2,1,1,1,2,1,2,2,1,1,1,1,3,2,2,3,4,3,2,2,4,2,5,5,3
128,1,2,3,1,2,0,1,1,4,4,1,4,1,2,10,1,1,2,2,2,2,3,4,1,2,2,5,2,1,3,3,2,3,2,3,2,2,4,4,4,2,2,2,2,2,2,3,3,2,2,2,2,2,2,2,3,2,2,3,3,3,3,3,3,3,3,3,3,3,2,3,3,3,3,3,3,3,3,3,3,3,3,2,3,3,1,1,2,1,1,1,1,2,1,1,1,1,1,1,1,1,1,2,2,2,3,2,2,3,1,3,2,1,1,3
129,2,1,1,2,0,0,2,2,3,2,2,2,1,2,10,2,1,4,5,2,5,4,4,2,3,4,1,3,5,5,4,4,3,2,4,2,2,5,4,3,3,5,2,2,2,2,3,4,2,4,1,3,3,2,1,4,2,1,4,1,3,3,3,3,3,3,4,5,1,5,3,5,5,3,3,5,1,3,3,2,5,5,5,1,1,1,2,2,2,1,2,2,1,2,1,1,2,2,2,1,2,1,5,4,5,4,4,3,2,3,5,3,4,3,5
130,1,4,1,1,1,3,2,1,4,2,2,2,1,2,10,1,2,5,4,2,2,1,1,1,5,2,3,5,3,1,1,1,4,2,4,2,3,3,5,3,2,2,4,2,5,3,4,3,2,3,2,2,2,2,3,2,4,4,4,3,4,4,4,2,4,3,4,3,3,4,4,4,3,4,4,4,3,4,4,4,4,3,2,2,2,2,2,2,2,1,2,2,1,2,2,1,2,2,1,1,1,1,2,3,3,4,4,4,2,2,3,2,5,5,2
131,1,4,1,1,1,2,2,2,1,1,3,2,1,3,10,1,1,3,3,2,3,2,4,2,4,4,3,3,3,2,4,4,3,3,2,3,2,2,1,2,3,3,3,3,4,2,2,2,2,3,2,4,3,2,3,2,3,4,4,2,4,4,4,2,3,4,4,4,4,3,2,4,4,3,5,3,2,4,4,3,4,2,2,2,2,2,1,2,1,1,2,1,1,2,1,1,2,2,2,2,2,1,4,4,4,4,3,4,3,2,3,3,3,4,2
132,2,2,1,1,1,3,2,2,3,2,2,3,2,3,10,2,1,3,3,3,2,1,1,3,2,2,3,1,3,3,4,3,3,3,3,3,2,2,2,1,3,2,3,1,3,2,2,2,4,1,1,1,1,1,2,2,2,2,3,2,2,3,3,4,2,1,1,3,2,2,3,3,3,3,3,3,4,4,2,2,2,3,4,3,3,2,1,1,1,2,2,2,2,2,1,1,2,2,2,2,1,2,2,1,2,3,4,4,3,3,3,1,4,5,3
133,1,1,1,2,0,0,1,1,3,2,2,2,1,4,10,2,2,5,5,5,5,3,3,2,3,3,4,5,4,2,1,3,3,3,5,4,2,5,3,2,5,4,4,3,5,5,3,3,3,3,2,2,2,1,3,3,3,3,3,3,3,5,3,1,1,3,1,5,5,3,3,3,5,3,3,3,3,5,3,3,5,3,4,2,2,2,2,1,1,2,2,2,2,2,1,1,2,2,2,2,1,1,2,3,3,4,4,4,4,2,4,3,5,5,3
134,1,2,2,1,1,3,2,2,2,1,3,4,2,2,10,1,1,3,2,1,3,3,3,1,3,3,5,5,5,3,1,5,5,4,2,1,3,5,1,3,1,3,3,3,3,1,2,3,1,1,1,3,4,2,2,2,4,4,3,2,4,3,3,5,4,2,4,1,5,5,1,3,5,4,5,3,3,3,4,4,4,4,3,2,1,2,1,1,1,1,2,1,2,2,1,1,1,2,1,2,1,1,4,5,2,1,5,4,5,4,2,1,5,5,2
135,2,2,1,1,1,3,1,1,4,3,1,4,1,2,10,2,2,2,2,1,4,3,5,4,5,3,1,4,2,4,2,4,4,3,5,3,1,3,1,3,1,2,3,2,5,2,3,4,1,3,3,3,3,2,5,5,3,2,3,3,2,4,3,1,3,3,4,5,4,4,3,3,3,3,4,2,3,3,3,5,1,1,1,1,3,1,1,1,1,1,2,1,1,2,1,1,2,2,2,2,1,1,3,4,4,4,4,5,2,4,4,3,4,5,4
136,1,5,1,1,1,2,2,1,4,3,1,4,1,4,10,1,1,3,3,2,3,3,4,2,3,4,4,4,3,3,3,1,2,3,3,2,2,4,2,2,2,2,2,1,3,4,3,2,3,4,4,4,4,2,2,2,4,4,4,3,1,2,4,3,4,4,4,3,2,4,2,3,3,4,4,3,2,4,3,3,4,4,2,2,1,2,2,1,1,2,2,2,1,1,2,1,2,2,2,2,1,1,4,3,5,4,4,4,5,3,4,5,5,5,4
137,1,2,1,1,1,1,1,2,3,2,2,3,1,1,10,1,1,3,3,2,3,5,5,4,3,4,2,4,4,4,3,5,3,2,2,3,5,3,1,5,3,4,4,3,4,1,2,5,2,3,1,5,4,2,3,2,2,3,4,3,3,2,2,3,3,2,2,1,4,2,3,4,2,4,4,2,2,5,5,4,5,1,4,1,2,2,1,2,1,1,2,1,2,2,1,2,1,1,1,1,2,2,3,4,4,5,4,2,2,3,4,3,3,3,3
138,1,1,3,2,0,0,2,1,2,1,3,2,2,2,10,2,2,2,3,2,5,3,4,5,2,1,2,2,2,4,2,3,2,2,1,2,2,4,1,3,1,2,3,2,2,1,2,2,1,5,3,2,5,1,2,1,4,4,2,3,3,4,3,1,1,1,2,4,3,5,3,4,1,4,3,4,1,4,4,2,3,5,2,1,4,2,2,2,1,1,1,1,1,2,1,1,1,1,1,1,1,1,1,1,1,5,5,3,3,3,2,1,5,4,4
139,1,4,1,1,2,0,1,1,2,1,3,4,2,3,10,1,1,4,4,5,5,4,3,2,2,3,1,4,4,2,5,3,5,3,2,3,3,1,1,3,3,3,4,3,5,1,2,4,3,4,3,5,4,2,3,3,3,5,2,2,4,4,4,2,2,4,4,3,4,5,5,3,3,4,5,3,2,4,4,2,5,3,2,2,2,2,2,2,2,2,2,1,1,1,1,1,2,1,1,2,1,1,3,2,3,2,4,3,3,3,2,3,4,4,2
140,1,2,1,1,2,0,1,2,3,3,2,3,1,3,10,1,2,3,4,3,2,2,3,1,3,5,2,1,4,2,2,2,3,2,2,1,2,2,2,2,2,4,2,4,5,2,3,4,2,3,2,4,3,2,1,3,3,4,3,3,4,3,3,3,4,3,2,3,4,4,5,4,4,2,5,3,4,5,5,2,4,1,1,2,3,2,1,2,1,2,2,1,1,2,1,1,1,2,1,1,1,1,4,2,4,2,4,3,2,1,3,4,4,3,2
141,2,2,1,1,1,2,2,2,4,4,1,2,1,4,10,1,2,1,3,2,1,2,1,1,2,3,1,2,3,2,3,4,3,2,5,2,2,1,4,5,2,3,2,3,3,1,3,2,2,1,2,1,3,2,3,4,3,4,4,5,5,3,2,2,1,3,5,1,2,3,2,3,1,3,4,5,2,3,2,1,4,3,2,2,3,2,2,2,1,1,2,1,2,2,1,1,1,1,2,2,1,1,4,4,2,2,4,3,1,3,1,4,4,5,2
142,2,1,1,2,0,0,2,2,3,2,2,3,1,2,10,2,1,3,3,2,2,3,3,3,2,2,3,3,3,4,3,3,3,2,3,2,1,2,1,3,2,3,3,3,3,2,2,4,1,1,2,2,2,5,2,4,3,3,3,2,5,4,4,2,3,4,5,4,3,5,3,2,2,3,3,3,4,4,5,2,4,1,1,1,1,2,2,2,1,2,2,1,1,2,1,2,2,2,2,2,2,1,3,3,3,2,3,2,2,4,4,3,4,4,3
143,1,4,1,1,1,3,2,2,4,3,1,4,1,4,10,1,2,3,3,2,2,3,3,3,4,2,2,3,3,4,4,3,3,2,3,5,1,2,1,1,2,3,2,2,4,2,2,4,1,1,2,2,3,2,2,4,3,3,3,2,5,4,4,2,3,4,4,4,3,5,3,2,2,3,3,3,3,4,4,3,4,1,1,1,2,1,1,2,1,2,2,1,1,2,1,2,2,2,2,1,2,1,3,3,3,2,3,2,2,4,4,3,4,5,3
144,1,2,2,1,1,1,2,1,2,1,3,2,2,1,10,1,2,5,4,3,4,2,5,1,3,2,2,5,3,4,3,1,2,3,2,2,1,4,1,3,1,1,3,3,1,1,2,2,1,4,1,1,1,1,1,1,3,1,3,3,2,1,1,1,3,3,2,2,1,4,1,1,1,1,2,3,2,3,3,3,4,4,3,2,2,1,1,1,1,1,1,2,2,1,1,1,2,2,1,1,1,1,3,4,2,3,4,3,3,4,3,2,5,4,4
145,2,5,1,1,1,2,2,1,4,4,1,2,1,2,10,2,1,2,2,2,3,3,5,4,3,4,2,4,2,3,4,1,2,3,4,2,1,1,2,1,1,1,3,3,3,2,2,3,1,1,1,1,1,1,3,3,3,2,3,3,4,4,3,1,3,3,4,4,1,5,3,4,1,2,3,3,2,3,3,3,2,4,3,3,2,1,1,1,2,1,1,2,2,2,1,1,2,2,2,1,1,1,3,4,4,3,4,4,3,4,3,2,4,5,3
146,1,1,1,2,0,0,1,2,3,2,2,2,1,3,10,1,2,4,4,3,2,1,1,1,1,1,1,1,1,3,1,2,2,5,2,3,2,1,2,4,1,2,2,3,3,2,1,2,2,2,3,2,2,3,2,2,3,3,3,4,5,4,3,2,2,2,3,2,3,5,4,1,2,3,2,4,4,3,4,2,3,3,4,5,5,1,1,2,1,1,1,1,1,1,1,1,1,1,1,1,2,1,1,1,1,1,1,1,1,3,4,1,5,5,3
147,1,3,1,1,2,0,1,2,2,1,3,3,2,3,10,1,2,5,5,2,3,2,3,3,2,2,3,3,3,3,2,3,3,3,3,4,2,3,3,3,4,4,3,2,3,1,3,5,2,3,3,3,3,2,3,3,4,2,2,3,3,3,3,3,3,3,4,2,3,4,4,2,3,4,4,3,1,3,4,2,3,4,3,2,2,2,2,2,2,2,2,2,2,2,2,2,2,2,2,2,1,1,4,3,3,2,4,4,2,2,3,2,5,5,2
148,1,2,3,1,1,1,2,1,2,1,3,3,2,1,10,2,1,2,1,1,2,2,3,2,3,2,3,4,2,3,3,1,1,2,3,2,2,2,2,2,2,3,3,2,2,2,2,2,1,2,2,1,3,2,2,4,3,3,2,2,2,5,5,1,1,1,1,1,1,2,2,2,2,3,4,2,2,1,3,4,3,3,4,4,4,2,1,2,1,2,1,1,1,1,1,1,1,2,2,1,1,1,2,1,2,3,5,4,2,3,4,2,5,4,4
149,2,2,1,1,1,1,1,1,4,3,1,2,1,4,10,2,1,2,2,3,2,4,3,3,2,3,4,1,1,3,2,4,2,3,3,3,2,2,2,4,3,1,4,1,3,1,2,3,1,1,1,2,1,1,1,3,3,4,4,3,4,3,4,2,2,5,5,4,1,4,3,1,5,3,1,1,1,3,3,1,5,3,3,2,2,1,1,2,1,1,2,1,1,1,1,1,1,1,2,2,2,2,2,4,3,3,2,1,3,4,3,1,5,5,3
150,1,4,1,1,2,0,2,2,4,3,1,2,1,2,10,1,2,1,1,1,1,1,4,2,4,3,3,1,3,3,3,2,2,1,3,2,2,2,3,4,3,3,2,2,2,1,4,3,2,3,3,3,4,4,5,5,4,3,5,2,2,2,2,1,1,1,1,1,1,1,1,1,1,1,3,2,3,3,4,3,5,3,3,2,2,2,1,1,1,1,1,1,1,1,1,1,1,1,1,1,1,1,1,1,1,1,3,4,2,2,3,2,4,4,2
151,1,1,2,1,1,2,2,2,3,2,2,4,1,1,10,1,2,2,2,1,1,1,3,5,4,4,2,4,2,4,3,3,1,4,4,3,2,5,4,5,3,3,3,2,3,2,2,5,2,4,1,4,4,1,2,2,5,4,4,3,4,4,3,1,5,3,2,5,4,5,4,3,5,4,4,4,4,5,4,4,4,1,1,2,1,2,2,2,1,2,2,1,1,2,1,1,2,2,2,2,1,1,2,2,2,3,4,4,4,2,4,3,3,3,1
152,1,5,1,1,2,0,1,1,2,1,3,2,2,2,10,2,1,2,2,3,1,3,1,1,2,3,2,3,2,3,4,5,2,2,4,2,1,4,1,2,1,2,1,1,3,1,1,2,1,1,1,1,3,4,2,4,5,5,2,5,2,3,5,1,3,2,4,5,2,4,3,3,5,5,4,5,5,5,5,4,5,5,3,5,5,2,1,2,1,2,2,1,1,2,1,1,2,2,1,1,1,1,4,2,4,4,2,3,2,2,4,2,4,4,2
153,1,2,1,1,1,1,2,2,4,4,2,4,1,2,10,1,2,4,4,2,3,2,2,2,5,2,5,5,3,5,5,3,5,4,5,5,2,3,1,3,5,4,5,3,5,4,2,5,1,5,2,3,2,3,4,1,5,4,3,2,4,3,2,1,3,5,5,5,5,5,3,2,5,5,5,5,3,5,5,5,4,5,2,3,1,2,2,2,1,1,2,2,1,2,1,1,2,2,2,2,1,1,5,3,2,5,4,3,3,5,2,3,5,4,3
154,2,2,1,1,1,1,2,2,3,3,1,3,1,4,10,1,1,3,2,1,3,4,1,1,1,1,1,1,2,1,4,3,2,2,2,2,2,3,1,3,2,3,2,5,5,4,1,2,1,1,1,2,2,2,1,2,1,2,1,1,3,3,3,1,1,2,2,2,4,3,1,1,3,4,3,5,2,2,1,2,5,5,1,5,5,2,2,2,2,2,2,1,2,2,1,1,1,2,2,1,1,1,3,2,2,2,4,4,2,4,3,3,2,2,2
155,2,1,1,2,0,0,2,1,3,2,2,3,1,4,10,1,1,3,2,2,1,5,2,1,1,1,2,2,2,5,2,5,2,5,1,5,1,5,3,2,3,3,3,3,5,1,1,1,3,1,1,1,1,1,1,4,4,4,5,3,2,2,2,1,1,3,3,5,5,3,4,4,5,4,4,4,3,5,5,3,4,5,1,5,5,2,2,2,1,2,2,2,2,2,1,1,2,2,2,1,2,1,3,1,3,5,4,4,2,3,4,2,4,5,2
156,1,3,1,1,1,1,2,1,3,2,2,2,1,1,10,1,2,5,1,4,5,5,5,3,4,4,5,2,5,5,5,3,3,5,2,5,4,4,5,4,2,3,3,3,5,2,5,1,5,5,5,3,3,1,5,4,5,5,5,5,5,2,3,3,5,4,4,2,4,4,5,5,2,2,5,5,2,5,5,5,5,5,5,1,3,2,2,2,2,1,1,1,1,2,1,1,1,2,2,1,2,1,5,2,3,1,5,5,1,3,3,4,5,5,2
157,2,2,3,1,1,1,1,2,4,4,1,4,1,1,10,2,1,3,5,2,5,2,5,1,3,1,2,3,4,5,5,5,4,3,2,5,5,3,2,1,2,3,1,1,4,1,4,5,3,1,2,4,3,1,1,3,5,5,4,3,5,5,5,1,3,5,5,5,5,4,3,3,2,4,5,2,1,3,3,2,5,3,3,5,5,1,2,2,1,1,2,1,1,1,2,1,2,2,1,1,1,1,3,2,3,3,4,3,2,2,4,2,5,5,3
158,1,2,1,1,1,1,2,1,4,4,1,2,1,2,10,1,2,2,2,2,2,3,4,1,2,2,5,2,1,3,3,2,3,2,3,2,2,4,4,4,4,2,2,2,2,2,3,3,2,2,2,2,2,2,2,3,2,2,3,3,3,3,3,3,3,3,3,3,3,2,3,3,3,3,3,3,3,3,3,3,3,3,2,3,3,1,1,2,1,1,1,1,2,1,1,1,1,1,1,1,1,1,3,2,2,3,2,2,3,1,3,2,1,1,3
159,1,4,1,1,2,0,1,2,2,1,3,3,2,2,10,2,1,4,5,2,5,4,4,2,3,4,1,3,5,5,4,4,3,2,4,2,2,5,4,3,3,5,2,2,2,2,3,4,2,4,1,3,3,2,1,4,2,1,4,1,3,3,3,3,3,3,4,5,1,5,3,5,5,3,3,5,1,3,3,2,5,5,5,1,1,1,2,2,2,1,2,2,1,2,1,1,2,2,2,1,2,1,5,4,5,4,4,3,3,3,5,3,4,3,5
160,1,1,2,2,0,0,2,2,3,3,2,2,3,4,10,1,2,5,4,2,2,1,1,1,5,2,3,5,3,1,1,1,4,2,4,2,3,3,5,3,2,2,4,2,5,3,4,3,2,3,2,2,2,2,3,2,4,4,4,3,4,4,4,2,4,3,4,3,3,4,4,4,3,4,4,4,3,4,4,4,4,3,2,2,2,2,2,2,2,1,2,2,1,2,2,1,2,2,1,1,1,1,2,3,3,4,4,4,3,4,3,2,5,5,2
161,1,5,1,1,2,0,2,1,2,1,3,4,2,3,10,1,1,3,3,2,3,2,4,2,4,4,3,3,3,2,4,4,3,3,2,3,2,2,1,2,3,3,3,3,4,2,2,2,2,3,2,4,3,2,3,2,3,4,4,2,4,4,4,2,3,4,4,4,4,3,2,4,4,3,5,3,2,4,4,3,4,2,2,2,2,2,1,2,1,1,2,1,1,2,1,1,2,2,2,2,2,1,4,4,4,4,3,4,3,4,3,3,3,4,2
162,2,2,1,1,1,1,1,2,3,2,2,4,1,2,10,2,2,3,3,3,2,1,1,3,2,2,3,1,3,3,4,3,3,3,3,3,2,2,2,3,3,2,3,1,3,2,2,2,4,1,1,1,1,1,2,2,2,2,3,2,2,3,3,4,2,1,1,3,2,2,3,3,3,3,3,3,4,4,2,2,2,3,4,3,3,2,1,1,1,2,2,2,2,2,1,1,2,2,2,2,1,2,2,1,3,3,4,4,3,3,3,1,4,5,3
163,2,2,1,1,1,3,1,1,4,4,1,3,1,1,10,2,1,5,5,5,5,3,3,2,3,3,4,5,4,2,1,3,3,3,5,4,2,5,3,2,5,4,4,3,5,5,3,3,3,3,2,2,2,1,3,3,3,3,3,3,3,5,3,1,1,3,1,5,5,3,3,3,5,3,3,3,3,5,3,3,5,3,4,2,2,2,2,1,1,2,2,2,2,2,1,1,2,2,2,2,1,1,2,2,2,4,4,4,4,2,4,3,5,5,3
164,1,1,1,2,0,0,1,2,4,4,1,2,1,2,10,2,2,3,2,1,3,3,3,1,3,3,5,5,5,3,1,5,5,4,2,1,3,5,1,3,1,3,3,3,3,1,2,3,1,1,1,3,4,2,2,2,4,4,3,2,4,3,3,5,4,2,4,1,5,5,1,3,5,4,5,3,3,3,4,4,4,4,3,2,1,2,1,1,1,1,2,1,2,2,1,1,1,2,1,2,1,1,4,5,3,1,5,4,5,2,2,1,5,5,2
165,2,5,3,1,1,1,2,1,3,4,1,2,1,3,10,1,1,2,2,1,4,3,5,4,5,3,1,4,2,4,2,4,4,3,5,3,1,3,1,3,1,2,3,2,5,2,3,4,1,3,3,3,3,2,5,5,3,2,3,3,2,4,3,1,3,3,4,5,4,4,3,3,3,3,4,2,3,3,3,5,1,1,1,1,3,1,1,1,1,1,2,1,1,2,1,1,2,2,2,2,1,1,2,4,4,4,4,5,2,2,4,3,4,5,4
166,1,2,1,1,1,1,1,2,3,2,2,4,1,4,10,1,2,3,3,2,3,3,4,2,3,4,4,4,3,3,3,1,2,3,3,2,2,4,2,2,2,2,2,1,3,2,3,2,3,4,4,4,4,2,2,2,4,4,4,3,1,2,4,3,4,4,4,3,2,4,2,3,3,4,4,3,2,4,3,3,4,4,2,2,1,2,2,1,1,2,2,2,1,1,2,1,2,2,2,2,1,1,4,3,5,4,4,4,5,3,4,5,5,5,4
167,1,4,1,1,1,3,1,2,4,4,1,4,1,2,10,2,1,3,3,2,3,5,5,4,3,4,2,4,4,4,3,5,3,2,2,3,5,3,1,5,3,4,4,3,4,1,2,5,2,3,1,5,4,2,3,2,2,3,4,3,3,2,2,3,3,2,2,1,4,2,3,4,2,4,4,2,2,5,5,4,5,1,4,1,2,2,1,2,1,1,2,1,2,2,1,2,1,1,1,1,2,2,3,4,4,5,4,2,2,3,4,3,3,3,3
168,2,1,1,2,0,0,1,1,3,4,1,2,1,3,10,2,2,2,3,2,5,3,4,5,2,1,2,2,2,4,2,3,2,1,1,2,2,4,1,3,1,2,3,2,2,1,2,2,1,5,3,2,5,1,2,1,4,4,2,3,3,4,3,1,1,1,2,4,3,5,3,4,1,4,3,4,1,4,4,2,3,5,2,1,4,2,2,2,1,1,1,1,1,2,1,1,1,1,1,1,1,1,1,1,1,5,5,3,3,3,2,1,5,4,4
169,1,4,2,3,0,0,2,2,3,2,2,2,1,2,10,2,1,4,4,5,5,4,3,2,2,3,1,4,4,2,5,3,5,3,2,3,3,1,1,3,3,3,4,3,5,1,2,4,3,4,3,5,4,2,3,3,3,5,2,2,4,4,4,2,2,4,4,3,4,5,5,3,3,4,5,3,2,4,4,2,5,3,2,2,2,2,2,2,2,2,2,1,1,1,1,1,2,1,1,2,1,1,2,3,3,2,4,3,3,3,2,3,4,4,2
170,2,2,1,1,1,1,2,2,4,4,1,2,1,2,10,1,2,3,4,3,2,2,3,1,3,5,2,3,4,2,2,2,3,2,2,1,2,2,2,2,2,4,2,4,5,2,3,4,2,3,2,4,3,2,1,3,3,4,3,3,4,3,3,3,4,3,2,3,4,4,5,4,4,2,5,3,4,5,5,2,4,1,1,2,3,2,1,2,1,2,2,1,1,2,1,1,1,2,1,1,1,1,4,2,4,2,4,3,2,1,3,4,4,3,2
171,1,2,1,1,1,1,2,1,3,2,2,3,1,1,10,2,1,1,3,2,1,2,1,1,2,3,1,2,3,2,3,4,1,2,5,2,2,1,4,5,2,3,2,3,3,1,3,2,2,1,2,1,3,2,3,4,3,4,4,5,5,3,2,2,1,3,5,1,2,3,2,3,1,3,4,5,2,3,2,1,4,3,2,2,3,2,2,2,1,1,2,1,2,2,1,1,1,1,2,2,1,1,4,4,2,2,4,3,1,3,1,4,4,5,2
172,2,5,1,1,1,0,2,2,4,4,1,3,1,1,10,1,2,3,3,2,2,3,3,3,2,2,3,3,3,4,3,3,3,2,3,2,1,2,1,1,2,3,3,3,3,2,2,4,1,1,2,2,2,5,2,4,3,3,3,2,5,4,4,2,3,4,5,4,3,5,3,2,2,3,3,3,4,4,5,2,4,1,1,1,1,2,2,2,1,2,2,1,1,2,1,2,2,2,2,2,2,1,3,3,3,2,3,2,2,4,4,3,4,4,3
173,1,4,1,3,0,0,2,2,3,3,2,2,1,4,10,2,1,3,3,2,2,3,3,3,4,2,2,1,3,4,4,3,3,2,3,5,1,2,1,3,4,3,2,2,4,2,2,4,1,1,2,2,3,2,2,4,3,3,3,2,5,4,4,2,3,4,4,4,3,5,3,2,2,3,3,3,3,4,4,3,4,1,1,1,2,1,1,2,1,2,2,1,1,2,1,2,2,2,2,1,2,1,2,3,2,2,3,2,2,4,4,3,4,5,3
174,2,2,3,1,1,1,2,1,4,4,1,2,1,1,10,2,2,5,4,3,4,2,5,1,3,2,2,5,3,4,3,1,2,3,2,2,1,4,1,3,1,1,3,3,1,1,2,2,1,4,1,1,1,1,1,1,3,1,3,3,2,1,1,1,3,3,2,2,1,4,1,1,1,1,2,3,2,3,3,3,4,4,3,2,2,1,1,1,1,1,1,2,2,1,1,1,2,2,1,1,1,1,2,4,3,3,4,3,3,4,3,2,5,4,4
175,1,2,1,1,2,0,2,2,3,2,2,4,3,1,10,1,1,2,2,2,3,3,5,4,3,4,2,4,2,3,4,1,2,3,4,2,1,1,2,1,1,1,3,3,3,2,2,3,1,1,1,1,1,1,3,3,3,2,3,3,4,4,3,1,3,3,4,4,1,5,3,4,1,2,3,3,2,3,3,3,2,4,3,3,2,1,1,1,2,1,1,2,2,2,1,1,2,2,2,1,1,1,2,4,4,3,4,4,2,4,3,2,4,5,3
176,1,5,1,1,2,0,1,2,3,3,2,4,1,2,10,2,2,4,4,3,2,1,1,1,1,1,1,1,1,3,1,2,2,5,2,3,2,1,2,4,1,2,2,3,3,2,1,2,2,2,3,2,2,3,2,2,3,3,3,4,5,4,3,2,2,2,3,2,3,5,4,1,2,3,2,4,4,3,4,2,3,3,4,5,5,1,1,2,1,1,1,1,1,1,1,1,1,1,1,1,2,1,1,1,1,1,1,1,1,3,4,1,5,5,3
177,2,2,1,2,0,0,2,1,3,3,1,3,1,4,10,1,1,5,5,2,3,2,3,3,2,2,3,3,3,3,2,3,3,3,3,4,2,3,3,3,4,4,3,2,3,1,3,5,2,3,3,3,3,2,3,3,4,2,2,3,3,3,3,3,3,3,4,2,3,4,4,2,3,4,4,3,1,3,4,2,3,4,3,2,2,2,2,2,2,2,2,2,2,2,2,2,2,2,2,2,1,1,4,2,3,2,4,4,3,2,3,2,5,5,2
178,1,5,3,3,0,0,2,1,3,3,2,2,1,3,10,2,2,2,1,1,2,2,3,2,3,2,3,1,2,3,3,1,1,2,3,2,2,2,2,2,2,3,3,2,2,2,2,2,1,2,2,1,3,2,2,4,3,3,2,2,2,5,5,1,1,1,1,1,1,2,2,2,2,3,4,2,2,1,3,4,3,3,4,4,4,2,1,2,1,2,1,1,1,1,1,1,1,2,2,1,1,1,2,1,2,3,5,4,2,3,4,2,5,4,4
179,2,3,1,1,1,2,2,2,4,4,1,2,1,1,10,1,2,2,2,3,2,4,3,3,2,3,4,4,1,3,2,4,2,3,3,3,2,2,2,4,3,1,4,1,3,1,2,3,1,1,1,2,1,1,1,3,3,4,4,3,4,3,4,2,2,5,5,4,1,4,3,1,5,3,1,1,1,3,3,1,5,3,3,2,2,1,1,2,1,1,2,1,1,1,1,1,1,1,2,2,2,2,2,4,3,3,2,1,3,4,3,1,5,5,3
180,1,2,1,1,2,0,2,1,3,3,2,3,1,2,10,2,1,1,1,1,1,1,4,2,4,3,3,3,3,3,3,2,2,1,3,2,2,2,3,4,3,3,2,2,2,1,4,3,2,3,3,3,4,4,5,5,4,3,5,2,2,2,2,1,1,1,1,1,1,1,1,1,1,1,3,2,3,3,4,3,5,3,3,2,2,2,1,1,1,1,1,1,1,1,1,1,1,1,1,1,1,1,1,1,1,1,3,4,2,2,3,2,4,4,2
181,2,5,1,3,0,0,2,2,3,3,2,3,1,2,10,2,2,2,2,1,1,1,3,5,4,4,2,4,2,4,3,3,3,4,4,3,2,5,4,5,3,3,3,2,3,2,2,5,2,4,1,4,4,1,2,2,5,4,4,3,4,4,3,1,5,3,2,5,4,5,4,3,5,4,4,4,4,5,4,4,4,1,1,2,1,2,2,2,1,2,2,1,1,2,1,1,2,2,2,2,1,1,3,3,2,3,4,4,4,4,4,3,3,3,1
182,2,2,1,1,1,2,2,1,4,4,1,2,1,4,10,1,2,2,2,3,1,3,1,1,2,3,2,3,2,3,4,5,2,2,4,2,1,4,1,2,1,2,1,1,3,1,1,2,1,1,1,1,3,4,2,4,5,5,2,5,2,3,5,1,3,2,4,5,2,4,3,3,5,5,4,5,5,5,5,4,5,5,3,5,5,2,1,2,1,2,2,1,1,2,1,1,2,2,1,1,1,1,4,2,4,4,2,3,2,2,4,2,4,4,2
183,1,2,3,1,1,1,2,1,3,3,2,4,1,1,10,2,1,4,4,2,3,2,2,2,5,2,5,5,3,5,5,3,5,4,5,5,2,3,1,3,5,4,5,3,5,4,2,5,1,5,2,3,2,3,4,1,5,4,3,2,4,3,2,1,3,5,5,5,5,5,3,2,5,5,5,5,3,5,5,5,4,5,2,3,1,2,2,2,1,1,2,2,1,2,1,1,2,2,2,2,1,1,5,3,3,5,4,3,3,5,2,3,5,4,3
184,1,2,1,1,2,0,2,2,4,4,1,2,1,2,10,2,2,3,2,1,3,4,1,1,1,1,1,1,2,1,4,3,2,2,2,2,2,3,1,3,2,3,2,5,5,2,1,2,1,1,1,2,2,2,1,2,1,2,1,1,3,3,3,1,1,2,2,2,4,3,1,1,3,4,3,5,2,2,1,2,5,5,1,5,5,2,2,2,2,2,2,1,2,2,1,1,1,2,2,1,1,1,3,2,2,2,4,4,3,4,3,3,2,2,2
185,1,5,1,1,1,3,1,1,3,3,2,4,1,2,10,2,2,3,2,2,1,5,2,1,1,1,2,2,2,5,2,5,2,5,1,5,1,5,3,2,3,3,3,3,5,1,1,1,3,1,1,1,1,1,1,4,4,4,5,3,2,2,2,1,1,3,3,5,5,3,4,4,5,4,4,4,3,5,5,3,4,5,1,5,5,2,2,2,1,2,2,2,2,2,1,1,2,2,2,1,2,1,3,1,2,5,4,4,3,3,4,2,4,5,2
186,2,5,2,4,0,0,2,1,3,3,2,2,1,4,10,1,2,5,1,4,5,5,5,3,4,4,5,2,5,5,5,3,3,5,2,5,4,4,5,4,2,3,3,3,5,2,5,1,5,5,5,3,3,1,5,4,5,5,5,5,5,2,3,3,5,4,4,2,4,4,5,5,2,2,5,5,2,5,5,5,5,5,5,1,3,2,2,2,2,1,1,1,1,2,1,1,1,2,2,1,2,1,5,2,3,1,5,5,1,3,3,4,5,5,2
187,1,2,1,1,2,0,1,2,4,4,1,2,1,2,10,2,2,3,5,2,5,2,5,1,3,1,2,1,4,5,5,5,4,3,2,5,5,3,2,1,2,3,1,1,4,1,4,5,3,1,2,4,3,1,1,3,5,5,4,3,5,5,5,1,3,5,5,5,5,4,3,3,2,4,5,2,1,3,3,2,5,3,3,5,5,1,2,2,1,1,2,1,1,1,2,1,2,2,1,1,1,1,2,2,2,3,4,3,2,2,4,2,5,5,3
188,1,2,1,1,2,0,2,1,3,3,2,1,2,4,10,2,2,2,2,2,2,3,4,1,2,2,5,2,1,3,3,2,3,2,3,2,2,4,4,4,2,2,2,2,2,2,3,3,2,2,2,2,2,2,2,3,2,2,3,3,3,3,3,3,3,3,3,3,3,2,3,3,3,3,3,3,3,3,3,3,3,3,2,3,3,1,1,2,1,1,1,1,2,1,1,1,1,1,1,1,1,1,3,2,2,3,2,2,3,1,3,2,1,1,3
189,1,5,1,1,2,0,2,2,3,3,2,3,1,2,10,1,1,4,5,2,5,4,4,2,3,4,1,3,5,5,1,4,3,2,4,2,2,5,4,3,3,5,2,2,2,2,3,4,2,4,1,3,3,2,1,4,2,1,4,1,3,3,3,3,3,3,4,5,1,5,3,5,5,3,3,5,1,3,3,2,5,5,5,1,1,1,2,2,2,1,2,2,1,2,1,1,2,2,2,1,2,1,5,4,5,4,4,3,2,3,5,3,4,3,5
190,2,2,1,2,0,0,1,1,3,3,2,2,1,3,10,1,2,5,4,2,2,1,1,1,5,2,3,5,3,1,4,1,4,2,4,2,3,3,5,1,2,2,4,2,5,3,4,3,2,3,2,2,2,2,3,2,4,4,4,3,4,4,4,2,4,3,4,3,3,4,4,4,3,4,4,4,3,4,4,4,4,3,2,2,2,2,2,2,2,1,2,2,1,2,2,1,2,2,1,1,1,1,2,3,3,4,4,4,2,4,3,2,5,5,2
191,1,2,1,1,1,1,2,2,3,3,2,1,1,2,10,2,1,3,3,2,3,2,4,2,4,4,3,3,3,2,4,4,1,3,2,3,2,2,1,2,3,3,3,3,4,2,2,2,2,3,2,4,3,2,3,2,3,4,4,2,4,4,4,2,3,4,4,4,4,3,2,4,4,3,5,3,2,4,4,3,4,2,2,2,2,2,1,2,1,1,2,1,1,2,1,1,2,2,2,2,2,1,4,4,4,4,3,4,3,4,3,3,3,4,2
192,1,2,1,1,2,0,2,1,4,4,1,2,1,4,10,1,2,3,3,3,2,1,1,3,2,2,3,3,3,3,4,3,3,3,3,3,2,2,2,3,3,2,3,1,3,2,2,2,4,1,1,1,1,1,2,2,2,2,3,2,2,3,3,4,2,1,1,3,2,2,3,3,3,3,3,3,4,4,2,2,2,3,4,3,3,2,1,1,1,2,2,2,2,2,1,1,2,2,2,2,1,2,2,1,2,3,4,4,3,3,3,1,4,5,3
193,1,4,2,3,0,0,2,1,3,3,2,2,1,1,1,1,1,5,5,5,5,3,3,2,3,3,4,5,4,2,1,3,3,3,5,4,2,5,3,2,5,4,4,3,5,5,3,3,3,3,2,2,2,1,3,3,3,3,3,3,3,5,3,1,1,3,1,5,5,3,3,3,5,3,3,3,3,5,3,3,5,3,4,2,2,2,2,1,1,2,2,2,2,2,1,1,2,2,2,2,1,1,2,2,3,4,4,4,4,2,4,3,5,5,3
194,2,1,1,1,1,1,1,2,4,4,1,4,1,4,1,2,2,3,2,1,3,3,3,1,3,3,5,5,5,3,1,5,5,4,2,1,3,5,1,3,1,3,3,3,3,1,2,3,1,1,1,3,4,2,2,2,4,4,3,2,4,3,3,5,4,2,4,1,5,5,1,3,5,4,5,3,3,3,4,4,4,4,3,2,1,2,1,1,1,1,2,1,2,2,1,1,1,2,1,2,1,1,4,5,2,1,5,4,5,2,2,1,5,5,2
195,1,3,1,2,0,0,2,2,3,2,2,3,1,2,1,1,1,2,2,1,4,3,5,4,5,3,1,4,2,4,2,4,4,3,5,3,1,3,1,3,1,2,3,2,5,2,3,4,1,3,3,3,3,2,5,5,3,2,3,3,2,4,3,1,3,3,4,5,4,4,3,3,3,3,4,2,3,3,3,5,1,1,1,1,3,1,1,1,1,1,2,1,1,2,1,1,2,2,2,2,1,1,3,4,4,4,4,5,2,2,4,3,4,5,4
196,1,2,1,4,0,0,1,2,3,2,2,3,1,1,1,2,2,3,3,2,3,3,4,2,3,4,4,1,3,3,3,1,2,3,3,2,2,4,2,2,2,2,2,1,3,2,3,2,3,4,4,4,4,2,2,2,4,4,4,3,1,2,4,3,4,4,4,3,2,4,2,3,3,4,4,3,2,4,3,3,4,4,2,2,1,2,2,1,1,2,2,2,1,1,2,1,2,2,2,2,1,1,4,2,5,4,4,4,5,3,4,5,5,5,4
197,1,4,1,1,1,2,2,1,1,1,3,1,2,3,1,2,1,3,3,2,3,5,5,4,3,4,2,4,4,4,3,5,3,2,2,3,5,3,1,5,3,4,4,3,4,1,2,5,2,3,1,5,4,2,3,2,2,3,4,3,3,2,2,3,3,2,2,1,4,2,3,4,2,4,4,2,2,5,5,4,5,1,4,1,2,2,1,2,1,1,2,1,2,2,1,2,1,1,1,1,2,2,3,4,4,5,4,2,2,3,4,3,3,3,3
198,2,1,1,1,1,2,2,2,3,4,2,3,1,2,1,1,1,2,3,2,5,3,4,5,2,1,2,2,2,4,2,3,2,2,1,2,2,4,1,3,1,2,3,2,2,1,2,2,1,5,3,2,5,1,2,1,4,4,2,3,3,4,3,1,1,1,2,4,3,5,3,4,1,4,3,4,1,4,4,2,3,5,2,1,4,2,2,2,1,1,1,1,1,2,1,1,1,1,1,1,1,1,1,1,1,5,5,3,3,3,2,1,5,4,4
199,1,4,1,2,0,0,1,1,3,2,2,1,1,4,1,2,2,4,4,5,5,4,3,2,2,3,1,4,4,2,5,3,5,3,2,3,3,1,1,3,3,3,4,3,5,1,2,4,3,4,3,5,4,2,3,3,3,5,2,2,4,4,4,2,2,4,4,3,4,5,5,3,3,4,5,3,2,4,4,2,5,3,2,2,2,2,2,2,2,2,2,1,1,1,1,1,2,1,1,2,1,1,3,2,3,2,4,3,3,3,2,3,4,4,2
200,1,2,1,3,0,0,1,2,4,2,1,4,1,2,1,1,1,3,4,3,2,2,3,1,3,5,2,1,4,2,2,2,3,2,2,1,2,2,2,2,2,4,2,4,5,2,3,4,2,3,2,4,3,2,1,3,3,4,3,3,4,3,3,3,4,3,2,3,4,4,5,4,4,2,5,3,4,5,5,2,4,1,1,2,3,2,1,2,1,2,2,1,1,2,1,1,1,2,1,1,1,1,4,2,4,2,4,3,2,1,3,4,4,3,2
201,1,3,1,1,1,2,2,2,4,4,2,3,1,4,1,2,2,1,3,2,1,2,1,1,2,3,1,2,3,2,3,4,3,2,5,2,2,1,4,5,2,3,2,3,3,1,3,2,2,1,2,1,3,2,3,4,3,4,4,5,5,3,2,2,1,3,5,1,2,3,2,3,1,3,4,5,2,3,2,1,4,3,2,2,3,2,2,2,1,1,2,1,2,2,1,1,1,1,2,2,1,1,4,4,2,2,4,3,1,3,1,4,4,5,2
202,1,1,1,1,1,3,1,1,4,3,1,4,1,2,1,1,1,3,3,2,2,3,3,3,2,2,3,3,3,4,3,3,3,2,3,2,1,2,1,3,2,3,3,3,3,5,2,4,1,1,2,2,2,5,2,4,3,3,3,2,5,4,4,2,3,4,5,4,3,5,3,2,2,3,3,3,4,4,5,2,4,1,1,1,1,2,2,2,1,2,2,1,1,2,1,2,2,2,2,2,2,1,2,2,2,2,3,2,2,4,4,3,4,4,3
203,2,3,3,1,1,3,1,2,2,4,2,2,1,1,1,1,1,3,3,2,2,3,3,3,4,2,2,3,3,4,4,3,3,2,3,5,1,2,1,3,2,3,2,2,4,2,2,4,1,1,2,2,3,2,2,4,3,3,3,2,5,4,4,2,3,4,4,4,3,5,3,2,2,3,3,3,3,4,4,3,4,1,1,1,2,1,1,2,1,2,2,1,1,2,1,2,2,2,2,1,2,1,3,3,3,2,3,2,2,4,4,3,4,5,3
204,1,3,1,2,0,0,2,2,4,2,1,4,1,2,1,2,2,5,4,3,4,2,5,1,3,2,2,5,3,4,3,1,2,3,2,2,1,4,1,3,1,1,3,3,1,1,2,2,1,4,1,1,1,1,1,1,3,1,3,3,2,1,1,1,3,3,2,2,1,4,1,1,1,1,2,3,2,3,3,3,4,4,3,2,2,1,1,1,1,1,1,2,2,1,1,1,2,2,1,1,1,1,2,4,2,3,4,3,3,4,3,2,5,4,4
205,1,2,1,3,0,0,1,2,2,3,2,1,1,2,1,1,1,2,2,2,3,3,5,4,3,4,2,4,2,3,4,1,2,3,4,2,1,1,2,3,1,1,3,3,3,2,2,3,1,1,1,1,1,1,3,3,3,2,3,3,4,4,3,1,3,3,4,4,1,5,3,4,1,2,3,3,2,3,3,3,2,4,3,3,2,1,1,1,2,1,1,2,2,2,1,1,2,2,2,1,1,1,2,4,4,3,4,4,2,4,3,2,4,5,3
206,1,4,1,1,2,0,2,2,2,2,2,3,1,3,1,2,1,4,4,3,2,1,1,1,1,1,1,1,1,3,1,2,2,5,2,3,2,1,2,4,1,2,2,3,3,2,1,2,2,2,3,2,2,3,2,2,3,3,3,4,5,4,3,2,2,2,3,2,3,5,4,1,2,3,2,4,4,3,4,2,3,3,4,5,5,1,1,2,1,1,1,1,1,1,1,1,1,1,1,1,2,1,1,1,1,1,1,1,1,3,4,1,5,5,3
207,2,1,2,1,1,3,1,2,2,1,3,3,2,4,1,1,2,5,5,2,3,2,3,3,2,2,3,3,3,3,2,3,3,3,3,4,2,3,3,3,4,4,3,2,3,1,3,5,2,3,3,3,3,2,3,3,4,2,2,3,3,3,3,3,3,3,4,2,3,4,4,2,3,4,4,3,1,3,4,2,3,4,3,2,2,2,2,2,2,2,2,2,2,2,2,2,2,2,2,2,1,1,4,3,3,2,4,4,3,2,3,2,5,5,2
208,1,4,1,1,2,0,2,2,4,2,2,2,1,2,1,1,1,2,1,1,2,2,3,2,3,2,3,4,2,3,3,1,1,2,3,2,2,2,2,2,4,3,3,2,2,2,2,2,1,2,2,1,3,2,2,4,3,3,2,2,2,5,5,1,1,1,1,1,1,2,2,2,2,3,4,2,2,1,3,4,3,3,4,4,4,2,1,2,1,2,1,1,1,1,1,1,1,2,2,1,1,1,2,1,2,3,5,4,2,3,4,2,5,4,4
209,1,2,1,2,0,0,2,1,3,2,1,4,1,3,1,1,1,2,2,3,2,4,3,3,2,3,4,1,1,3,2,4,2,3,3,3,2,2,2,4,3,1,4,1,3,1,2,3,1,1,1,2,1,1,1,3,3,4,4,3,4,3,4,2,2,5,5,4,1,4,3,1,5,3,1,1,1,3,3,1,5,3,3,2,2,1,1,2,1,1,2,1,1,1,1,1,1,1,2,2,2,2,2,4,3,3,2,1,3,4,3,1,5,5,3
210,1,3,1,1,1,2,1,2,4,4,1,3,1,2,1,2,2,1,1,1,1,1,4,2,4,3,3,3,3,3,3,2,2,1,3,2,2,2,3,4,3,3,2,2,2,1,4,3,2,3,3,3,4,4,5,5,4,3,5,2,2,2,2,1,1,1,1,1,1,1,1,1,1,1,3,2,3,3,4,3,5,3,3,2,2,2,1,1,1,1,1,1,1,1,1,1,1,1,1,1,1,1,1,1,1,1,3,4,2,2,3,2,4,4,2
211,2,1,3,2,0,0,2,1,1,1,3,2,2,1,1,1,1,2,2,1,1,1,3,5,4,4,2,4,2,4,3,3,3,4,4,3,2,5,4,5,3,3,3,2,3,2,2,5,2,4,1,4,4,1,2,2,5,4,4,3,4,4,3,1,5,3,2,5,4,5,4,3,5,4,4,4,4,5,4,4,4,1,1,2,1,2,2,2,1,2,2,1,1,2,1,1,2,2,2,2,1,1,3,3,3,3,4,4,4,4,4,3,3,3,1
212,2,3,1,2,0,0,2,2,2,2,1,4,1,2,1,1,1,2,2,3,1,3,1,1,2,3,2,3,2,3,4,5,2,2,4,2,1,4,1,2,1,2,1,1,3,1,1,2,1,1,1,1,3,4,2,4,5,5,2,5,2,3,5,1,3,2,4,5,2,4,3,3,5,5,4,5,5,5,5,4,5,5,3,5,5,2,1,2,1,2,2,1,1,2,1,1,2,2,1,1,1,1,4,2,4,4,2,3,2,2,4,2,4,4,2
213,1,2,1,1,2,0,2,2,3,2,2,3,1,3,1,2,2,4,4,2,3,2,2,2,5,2,5,5,3,5,5,3,5,4,5,5,2,3,1,3,5,4,5,3,5,4,2,5,1,5,2,3,2,3,4,1,5,4,3,2,4,3,2,1,3,5,5,5,5,5,3,2,5,5,5,5,3,5,5,5,4,5,2,3,1,2,2,2,1,1,2,2,1,2,1,1,2,2,2,2,1,1,5,3,2,5,4,3,3,5,2,3,5,4,3
214,2,2,1,2,0,0,1,1,3,2,2,2,1,3,1,1,1,3,2,1,3,4,1,1,1,1,1,1,2,1,4,3,2,2,2,2,2,3,1,3,2,3,2,5,5,5,1,2,1,1,1,2,2,2,1,2,1,2,1,1,3,3,3,1,1,2,2,2,4,3,1,1,3,4,3,5,2,2,1,2,5,5,1,5,5,2,2,2,2,2,2,1,2,2,1,1,1,2,2,1,1,1,2,2,2,2,4,4,3,4,3,3,2,2,2
215,1,1,2,1,1,2,2,2,4,4,1,4,1,1,1,2,2,3,2,2,1,5,2,1,1,1,2,2,2,5,2,5,2,5,1,5,1,5,3,2,3,3,3,3,5,1,1,1,3,1,1,1,1,1,1,4,4,4,5,3,2,2,2,1,1,3,3,5,5,3,4,4,5,4,4,4,3,5,5,3,4,5,1,5,5,2,2,2,1,2,2,2,2,2,1,1,2,2,2,1,2,1,2,1,2,5,4,4,2,3,4,2,4,5,2
216,1,3,1,1,1,1,1,2,3,4,2,3,1,2,1,1,1,5,1,4,5,5,5,3,4,4,5,2,5,5,5,3,3,5,2,5,4,4,5,4,2,3,3,3,5,2,5,1,5,5,5,3,3,1,5,4,5,5,5,5,5,2,3,3,5,4,4,2,4,4,5,5,2,2,5,5,2,5,5,5,5,5,5,1,3,2,2,2,2,1,1,1,1,2,1,1,1,2,2,1,2,1,5,2,3,1,5,5,1,3,3,4,5,5,2
217,2,3,1,2,0,0,2,1,3,2,2,1,1,2,1,1,1,3,5,2,5,2,5,1,3,1,2,1,4,5,5,5,4,3,2,5,5,3,2,1,2,3,1,1,4,1,4,5,3,1,2,4,3,1,1,3,5,5,4,3,5,5,5,1,3,5,5,5,5,4,3,3,2,4,5,2,1,3,3,2,5,3,3,5,5,1,2,2,1,1,2,1,1,1,2,1,2,2,1,1,1,1,3,2,2,3,4,3,2,2,4,2,5,5,3
218,1,2,1,1,1,2,1,2,4,4,1,1,1,4,1,2,2,2,2,2,2,3,4,1,2,2,5,2,1,3,3,2,3,2,3,2,2,4,4,4,2,2,2,2,2,2,3,3,2,2,2,2,2,2,2,3,2,2,3,3,3,3,3,3,3,3,3,3,3,2,3,3,3,3,3,3,3,3,3,3,3,3,2,3,3,1,1,2,1,1,1,1,2,1,1,1,1,1,1,1,1,1,3,2,2,3,2,2,3,1,3,2,1,1,3
219,2,4,3,2,0,0,2,1,3,2,2,4,1,1,1,1,1,4,5,2,5,4,4,2,3,4,1,3,5,5,1,4,3,2,4,2,2,5,4,3,3,5,2,2,2,2,3,4,2,4,1,3,3,2,1,4,2,1,4,1,3,3,3,3,3,3,4,5,1,5,3,5,5,3,3,5,1,3,3,2,5,5,5,1,1,1,2,2,2,1,2,2,1,2,1,1,2,2,2,1,2,1,5,4,5,4,4,3,2,3,5,3,4,3,5
220,1,1,1,1,1,1,2,2,1,1,3,3,2,2,1,2,2,5,4,2,2,1,1,1,5,2,3,5,3,1,4,1,4,2,4,2,3,3,5,3,2,2,4,2,5,3,4,3,2,3,2,2,2,2,3,2,4,4,4,3,4,4,4,2,4,3,4,3,3,4,4,4,3,4,4,4,3,4,4,4,4,3,2,2,2,2,2,2,2,1,2,2,1,2,2,1,2,2,1,1,1,1,2,3,3,4,4,4,3,4,3,2,5,5,2
221,1,3,1,4,0,0,1,1,4,2,1,4,1,3,1,1,1,3,3,2,3,2,4,2,4,4,3,3,3,2,4,4,3,3,2,3,2,2,1,2,3,3,3,3,4,2,2,2,2,3,2,4,3,2,3,2,3,4,4,2,4,4,4,2,3,4,4,4,4,3,2,4,4,3,5,3,2,4,4,3,4,2,2,2,2,2,1,2,1,1,2,1,1,2,1,1,2,2,2,2,2,1,4,4,4,4,3,4,3,4,3,3,3,4,2
222,1,2,1,1,1,3,2,1,3,3,2,3,1,1,1,2,2,3,3,3,2,1,1,3,2,2,3,1,3,3,1,3,3,3,3,3,2,2,2,3,3,2,3,1,3,2,2,2,4,1,1,1,1,1,2,2,2,2,3,2,2,3,3,4,2,1,1,3,2,2,3,3,3,3,3,3,4,4,2,2,2,3,4,3,3,2,1,1,1,2,2,2,2,2,1,1,2,2,2,2,1,2,2,1,2,3,4,4,2,3,3,1,4,5,3
223,2,2,3,2,0,0,1,2,3,2,2,3,1,4,1,2,2,5,5,5,5,3,3,2,3,3,4,5,4,2,4,3,3,3,5,4,2,5,3,2,5,4,4,3,5,5,3,3,3,3,2,2,2,1,3,3,3,3,3,3,3,5,3,1,1,3,1,5,5,3,3,3,5,3,3,3,3,5,3,3,5,3,4,2,2,2,2,1,1,2,2,2,2,2,1,1,2,2,2,2,1,1,2,2,3,4,4,4,4,2,4,3,5,5,3
224,1,3,1,1,1,2,1,2,4,4,1,1,1,2,1,1,1,3,2,1,3,3,3,1,3,3,5,5,5,3,1,5,5,4,2,1,3,5,1,3,1,3,3,3,3,1,2,3,1,1,1,3,4,2,2,2,4,4,3,2,4,3,3,5,4,2,4,1,5,5,1,3,5,4,5,3,3,3,4,4,4,4,3,2,1,2,1,1,1,1,2,1,2,2,1,1,1,2,1,2,1,1,4,5,2,1,5,4,5,4,2,1,5,5,2
225,1,3,1,2,0,0,1,2,3,2,2,3,1,4,1,1,1,2,2,1,4,3,5,4,5,3,1,1,2,4,2,4,4,3,5,3,1,3,1,3,1,2,3,2,5,2,3,4,1,3,3,3,3,2,5,5,3,2,3,3,2,4,3,1,3,3,4,5,4,4,3,3,3,3,4,2,3,3,3,5,1,1,1,1,3,1,1,1,1,1,2,1,1,2,1,1,2,2,2,2,1,1,2,4,4,4,4,5,2,2,4,3,4,5,4
226,1,3,1,1,2,0,1,1,3,3,2,4,1,1,1,1,1,3,3,2,3,3,4,2,3,4,4,4,3,3,3,1,2,3,3,2,2,4,2,2,2,2,2,1,3,2,3,2,3,4,4,4,4,2,2,2,4,4,4,3,1,2,4,3,4,4,4,3,2,4,2,3,3,4,4,3,2,4,3,3,4,4,2,2,1,2,2,1,1,2,2,2,1,1,2,1,2,2,2,2,1,1,4,3,5,4,4,4,5,3,4,5,5,5,4
227,2,2,1,1,1,1,1,2,3,4,2,2,1,2,1,2,2,3,3,2,3,5,5,4,3,4,2,4,4,4,3,5,3,2,2,3,5,3,1,5,3,4,4,3,4,1,2,5,2,3,1,5,4,2,3,2,2,3,4,3,3,2,2,3,3,2,2,1,4,2,3,4,2,4,4,2,2,5,5,4,5,1,4,1,2,2,1,2,1,1,2,1,2,2,1,2,1,1,1,1,2,2,3,4,4,5,4,2,2,3,4,3,3,3,3
228,1,2,1,1,1,2,2,1,4,3,1,4,1,3,2,1,2,2,3,2,5,3,4,5,2,1,2,2,2,4,2,3,2,2,1,2,2,4,1,3,1,2,3,2,2,1,2,2,1,5,3,2,5,1,2,1,4,4,2,3,3,4,3,1,1,1,2,4,3,5,3,4,1,4,3,4,1,4,4,2,3,5,2,1,4,2,2,2,1,1,1,1,1,2,1,1,1,1,1,1,1,1,1,1,1,5,5,3,3,3,2,1,5,4,4
229,2,1,2,1,1,1,2,2,3,4,2,3,1,1,2,2,1,4,4,5,5,4,3,2,2,3,1,4,4,2,5,3,5,3,2,3,3,1,1,3,3,3,4,3,5,1,2,4,3,4,3,5,4,2,3,3,3,5,2,2,4,4,4,2,2,4,4,3,4,5,5,3,3,4,5,3,2,4,4,2,5,3,2,2,2,2,2,2,2,2,2,1,1,1,1,1,2,1,1,2,1,1,3,3,3,2,4,3,3,3,2,3,4,4,2
230,1,4,1,2,0,0,2,2,3,2,2,3,3,2,2,1,2,3,4,3,2,2,3,1,3,5,2,3,4,2,2,2,3,2,2,1,2,2,2,2,2,4,2,4,5,2,3,4,2,3,2,4,3,2,1,3,3,4,3,3,4,3,3,3,4,3,2,3,4,4,5,4,4,2,5,3,4,5,5,2,4,1,1,2,3,2,1,2,1,2,2,1,1,2,1,1,1,2,1,1,1,1,4,2,4,2,4,3,2,1,3,4,4,3,2
231,2,4,1,2,0,0,1,1,3,2,2,3,1,4,2,2,2,1,3,2,1,2,1,1,2,3,1,2,3,2,3,4,1,2,5,2,2,1,4,5,2,3,2,3,3,1,3,2,2,1,2,1,3,2,3,4,3,4,4,5,5,3,2,2,1,3,5,1,2,3,2,3,1,3,4,5,2,3,2,1,4,3,2,2,3,2,2,2,1,1,2,1,2,2,1,1,1,1,2,2,1,1,4,4,2,2,4,3,1,3,1,4,4,5,2
232,1,2,3,1,1,2,2,2,2,1,3,1,2,2,2,1,2,3,3,2,2,3,3,3,2,2,3,1,3,4,3,3,3,2,3,2,1,2,1,3,4,3,3,3,3,2,2,4,1,1,2,2,2,5,2,4,3,3,3,2,5,4,4,2,3,4,5,4,3,5,3,2,2,3,3,3,4,4,5,2,4,1,1,1,1,2,2,2,1,2,2,1,1,2,1,2,2,2,2,2,2,1,3,2,3,2,3,2,2,4,4,3,4,4,3
233,1,2,1,2,0,0,2,1,4,2,2,2,1,1,3,1,1,3,3,2,2,3,3,3,4,2,2,3,3,4,4,3,3,2,3,5,1,2,1,3,2,3,2,2,4,2,2,4,1,1,2,2,3,2,2,4,3,3,3,2,5,4,4,2,3,4,4,4,3,5,3,2,2,3,3,3,3,4,4,3,4,1,1,1,2,1,1,2,1,2,2,1,1,2,1,2,2,2,2,1,2,1,2,2,3,2,3,2,2,4,4,3,4,5,3
234,2,3,3,1,1,2,1,2,4,4,1,4,1,2,3,2,2,5,4,3,4,2,5,1,3,2,2,5,3,4,3,1,2,3,2,2,1,4,1,3,1,1,3,3,1,1,2,2,1,4,1,1,1,1,1,1,3,1,3,3,2,1,1,1,3,3,2,2,1,4,1,1,1,1,2,3,2,3,3,3,4,4,3,2,2,1,1,1,1,1,1,2,2,1,1,1,2,2,1,1,1,1,2,4,2,3,4,3,3,4,3,2,5,4,4
235,1,4,1,1,1,2,2,1,3,3,2,3,1,2,3,1,1,2,2,2,3,3,5,4,3,4,2,4,2,3,4,1,2,3,4,2,1,1,2,3,1,1,3,3,3,2,2,3,1,1,1,1,1,1,3,3,3,2,3,3,4,4,3,1,3,3,4,4,1,5,3,4,1,2,3,3,2,3,3,3,2,4,3,3,2,1,1,1,2,1,1,2,2,2,1,1,2,2,2,1,1,1,2,4,4,3,4,4,3,4,3,2,4,5,3
236,1,1,1,2,0,0,1,2,3,2,2,3,1,2,3,1,2,4,4,3,2,1,1,1,1,1,1,1,1,3,1,2,2,5,2,3,2,1,2,4,1,2,2,3,3,2,1,2,2,2,3,2,2,3,2,2,3,3,3,4,5,4,3,2,2,2,3,2,3,5,4,1,2,3,2,4,4,3,4,2,3,3,4,5,5,1,1,2,1,1,1,1,1,1,1,1,1,1,1,1,2,1,1,1,1,1,1,1,1,3,4,1,5,5,3
237,2,3,1,1,1,2,1,1,3,3,2,2,1,1,3,1,2,5,5,2,3,2,3,3,2,2,3,3,3,3,2,3,3,3,3,4,2,3,3,3,4,4,3,2,3,1,3,5,2,3,3,3,3,2,3,3,4,2,2,3,3,3,3,3,3,3,4,2,3,4,4,2,3,4,4,3,1,3,4,2,3,4,3,2,2,2,2,2,2,2,2,2,2,2,2,2,2,2,2,2,1,1,4,3,3,2,4,4,3,2,3,2,5,5,2
238,1,2,2,3,0,0,2,1,4,2,1,4,1,3,3,1,1,2,1,1,2,2,3,2,3,2,3,4,2,3,3,1,1,2,3,2,2,2,2,2,2,3,3,2,2,2,2,2,1,2,2,1,3,2,2,4,3,3,2,2,2,5,5,1,1,1,1,1,1,2,2,2,2,3,4,2,2,1,3,4,3,3,4,4,4,2,1,2,1,2,1,1,1,1,1,1,1,2,2,1,1,1,2,1,2,3,5,4,2,3,4,2,5,4,4
239,1,2,1,2,0,0,2,2,1,1,3,2,2,2,3,2,2,2,2,3,2,4,3,3,2,3,4,1,1,3,2,4,2,3,3,3,2,2,2,4,3,1,4,1,3,1,2,3,1,1,1,2,1,1,1,3,3,4,4,3,4,3,4,2,2,5,5,4,1,4,3,1,5,3,1,1,1,3,3,1,5,3,3,2,2,1,1,2,1,1,2,1,1,1,1,1,1,1,2,2,2,2,2,4,3,3,2,1,3,4,3,1,5,5,3
240,1,4,1,1,1,2,1,2,4,3,2,3,1,4,3,1,2,1,1,1,1,1,4,2,4,3,3,3,3,3,3,2,2,1,3,2,2,2,3,4,3,3,2,2,2,1,4,3,2,3,3,3,4,4,5,5,4,3,5,2,2,2,2,1,1,1,1,1,1,1,1,1,1,1,3,2,3,3,4,3,5,3,3,2,2,2,1,1,1,1,1,1,1,1,1,1,1,1,1,1,1,1,1,1,1,1,3,4,2,2,3,2,4,4,2
241,1,3,1,1,2,0,2,2,2,1,3,1,2,1,3,1,1,2,2,1,1,1,3,5,4,4,2,4,2,4,3,3,3,4,4,3,2,5,4,5,3,3,3,2,3,2,2,5,2,4,1,4,4,1,2,2,5,4,4,3,4,4,3,1,5,3,2,5,4,5,4,3,5,4,4,4,4,5,4,4,4,1,1,2,1,2,2,2,1,2,2,1,1,2,1,1,2,2,2,2,1,1,3,3,3,3,4,4,4,4,4,3,3,3,1
242,2,2,1,1,1,1,2,2,4,4,1,4,1,2,3,2,2,2,2,3,1,3,1,1,2,3,2,3,2,3,4,5,2,2,4,2,1,4,1,2,1,2,1,1,3,1,1,2,1,1,1,1,3,4,2,4,5,5,2,5,2,3,5,1,3,2,4,5,2,4,3,3,5,5,4,5,5,5,5,4,5,5,3,5,5,2,1,2,1,2,2,1,1,2,1,1,2,2,1,1,1,1,4,2,4,4,2,3,2,2,4,2,4,4,2
243,1,2,3,1,2,0,1,1,4,3,2,3,1,4,3,1,1,4,4,2,3,2,2,2,5,2,5,5,3,5,5,3,5,4,5,5,2,3,1,3,5,4,5,3,5,4,2,5,1,5,2,3,2,3,4,1,5,4,3,2,4,3,2,1,3,5,5,5,5,5,3,2,5,5,5,5,3,5,5,5,4,5,2,3,1,2,2,2,1,1,2,2,1,2,1,1,2,2,2,2,1,1,5,3,2,5,4,3,3,5,2,3,5,4,3
244,1,4,1,2,0,0,2,2,4,2,2,1,1,1,3,2,2,3,2,1,3,4,1,1,1,1,1,1,2,1,4,3,2,2,2,2,2,3,1,3,2,3,2,5,5,2,1,2,1,1,1,2,2,2,1,2,1,2,1,1,3,3,3,1,1,2,2,2,4,3,1,1,3,4,3,5,2,2,1,2,5,5,1,5,5,2,2,2,2,2,2,1,2,2,1,1,1,2,2,1,1,1,3,2,2,2,4,4,3,2,3,3,2,2,2
245,2,1,1,1,1,3,1,1,3,3,2,3,1,3,3,1,1,3,2,2,1,5,2,1,1,1,2,2,2,5,2,5,2,5,1,5,1,5,3,2,3,3,3,3,5,1,1,1,3,1,1,1,1,1,1,4,4,4,5,3,2,2,2,1,1,3,3,5,5,3,4,4,5,4,4,4,3,5,5,3,4,5,1,5,5,2,2,2,1,2,2,2,2,2,1,1,2,2,2,1,2,1,3,1,3,5,4,4,2,3,4,2,4,5,2
246,1,3,1,2,0,0,2,1,3,2,2,2,1,2,3,2,2,5,1,4,5,5,5,3,4,4,5,2,5,5,5,3,3,5,2,5,4,4,5,4,2,3,3,3,5,2,5,1,5,5,5,3,3,1,5,4,5,5,5,5,5,2,3,3,5,4,4,2,4,4,5,5,2,2,5,5,2,5,5,5,5,5,5,1,3,2,2,2,2,1,1,1,1,2,1,1,1,2,2,1,2,1,5,2,3,1,5,5,1,3,3,4,5,5,2
247,1,2,1,1,2,0,1,1,4,3,1,4,1,1,3,1,2,3,5,2,5,2,5,1,3,1,2,1,4,5,5,5,4,3,2,5,5,3,2,1,2,3,1,1,4,1,4,5,3,1,2,4,3,1,1,3,5,5,4,3,5,5,5,1,3,5,5,5,5,4,3,3,2,4,5,2,1,3,3,2,5,3,3,5,5,1,2,2,1,1,2,1,1,1,2,1,2,2,1,1,1,1,3,2,3,3,4,3,2,2,4,2,5,5,3
248,1,2,2,4,0,0,1,2,4,2,2,3,1,3,3,1,1,2,2,2,2,3,4,1,2,2,5,2,1,3,3,2,3,2,3,2,2,4,4,4,2,2,2,2,2,2,3,3,2,2,2,2,2,2,2,3,2,2,3,3,3,3,3,3,3,3,3,3,3,2,3,3,3,3,3,3,3,3,3,3,3,3,2,3,3,1,1,2,1,1,1,1,2,1,1,1,1,1,1,1,1,1,2,2,2,3,2,2,3,1,3,2,1,1,3
249,1,4,1,1,2,0,1,1,1,1,3,1,2,2,3,1,1,4,5,2,5,4,4,2,3,4,1,3,5,5,4,4,3,2,4,2,2,5,4,3,3,5,2,2,2,2,3,4,2,4,1,3,3,2,1,4,2,1,4,1,3,3,3,3,3,3,4,5,1,5,3,5,5,3,3,5,1,3,3,2,5,5,5,1,1,1,2,2,2,1,2,2,1,2,1,1,2,2,2,1,2,1,5,4,5,4,4,3,3,3,5,3,4,3,5
250,2,1,1,1,1,3,2,2,4,4,1,4,1,4,3,2,2,5,4,2,2,1,1,1,5,2,3,5,3,1,1,1,4,2,4,2,3,3,5,3,2,2,4,2,5,3,4,3,2,3,2,2,2,2,3,2,4,4,4,3,4,4,4,2,4,3,4,3,3,4,4,4,3,4,4,4,3,4,4,4,4,3,2,2,2,2,2,2,2,1,2,2,1,2,2,1,2,2,1,1,1,1,2,3,3,4,4,4,3,4,3,2,5,5,2
251,1,3,1,1,2,0,2,2,3,3,2,2,1,1,3,1,1,3,3,2,3,2,4,2,4,4,3,3,3,2,4,4,3,3,2,3,2,2,1,2,3,3,3,3,4,2,2,2,2,3,2,4,3,2,3,2,3,4,4,2,4,4,4,2,3,4,4,4,4,3,2,4,4,3,5,3,2,4,4,3,4,2,2,2,2,2,1,2,1,1,2,1,1,2,1,1,2,2,2,2,2,1,4,4,4,4,3,4,3,4,3,3,3,4,2
252,2,2,1,2,0,0,2,1,4,3,2,3,1,2,3,1,1,3,3,3,2,1,1,3,2,2,3,3,3,3,4,3,3,3,3,3,2,2,2,3,3,2,3,1,3,2,2,2,4,1,1,1,1,1,2,2,2,2,3,2,2,3,3,4,2,1,1,3,2,2,3,3,3,3,3,3,4,4,2,2,2,3,4,3,3,2,1,1,1,2,2,2,2,2,1,1,2,2,2,2,1,2,2,1,2,3,4,4,3,3,3,1,4,5,3
253,1,3,2,3,0,0,1,2,3,2,2,1,1,3,3,2,2,5,5,5,5,3,3,2,3,3,4,5,4,2,1,3,3,3,5,4,2,5,3,2,5,4,4,3,5,5,3,3,3,3,2,2,2,1,3,3,3,3,3,3,3,5,3,1,1,3,1,5,5,3,3,3,5,3,3,3,3,5,3,3,5,3,4,2,2,2,2,1,1,2,2,2,2,2,1,1,2,2,2,2,1,1,2,3,3,4,4,4,4,2,4,3,5,5,3
254,1,2,1,1,2,0,2,1,3,3,1,4,1,1,3,1,1,3,2,1,3,3,3,1,3,3,5,5,5,3,1,5,5,4,2,1,3,5,1,3,1,3,3,3,3,1,2,3,1,1,1,3,4,2,2,2,4,4,3,2,4,3,3,5,4,2,4,1,5,5,1,3,5,4,5,3,3,3,4,4,4,4,3,2,1,2,1,1,1,1,2,1,2,2,1,1,1,2,1,2,1,1,4,5,2,1,5,4,5,4,2,1,5,5,2
255,1,1,1,1,1,1,2,1,3,4,2,3,1,4,3,1,1,2,2,1,4,3,5,4,5,3,1,1,2,4,2,4,4,3,5,3,1,3,1,3,1,2,3,2,5,2,3,4,1,3,3,3,3,2,5,5,3,2,3,3,2,4,3,1,3,3,4,5,4,4,3,3,3,3,4,2,3,3,3,5,1,1,1,1,3,1,1,1,1,1,2,1,1,2,1,1,2,2,2,2,1,1,3,4,4,4,4,5,2,4,4,3,4,5,4
256,1,3,1,1,2,0,1,2,2,1,3,2,2,2,3,2,2,3,3,2,3,3,4,2,3,4,4,4,3,3,3,1,2,3,3,2,2,4,2,2,2,2,2,1,3,2,3,2,3,4,4,4,4,2,2,2,4,4,4,3,1,2,4,3,4,4,4,3,2,4,2,3,3,4,4,3,2,4,3,3,4,4,2,2,1,2,2,1,1,2,2,2,1,1,2,1,2,2,2,2,1,1,4,2,5,4,4,4,5,3,4,5,5,5,4
257,1,2,1,1,1,2,2,1,3,4,2,3,1,3,3,1,2,3,3,2,3,5,5,4,3,4,2,4,4,4,3,5,3,2,2,3,5,3,1,5,3,4,4,3,4,1,2,5,2,3,1,5,4,2,3,2,2,3,4,3,3,2,2,3,3,2,2,1,4,2,3,4,2,4,4,2,2,5,5,4,5,1,4,1,2,2,1,2,1,1,2,1,2,2,1,2,1,1,1,1,2,2,3,4,4,5,4,2,2,3,4,3,3,3,3
258,1,2,1,2,0,0,2,2,3,2,2,1,1,1,3,2,2,2,3,2,5,3,4,5,2,1,2,2,2,4,2,3,2,2,1,2,2,4,1,3,1,2,3,2,2,1,2,2,1,5,3,2,5,1,2,1,4,4,2,3,3,4,3,1,1,1,2,4,3,5,3,4,1,4,3,4,1,4,4,2,3,5,2,1,4,2,2,2,1,1,1,1,1,2,1,1,1,1,1,1,1,1,1,1,1,5,5,3,2,3,2,1,5,4,4
259,2,4,3,1,1,1,1,1,4,3,1,4,1,3,3,1,1,4,4,5,5,4,3,2,2,3,1,4,4,2,5,3,5,3,2,3,3,1,1,3,3,3,4,3,5,1,2,4,3,4,3,5,4,2,3,3,3,5,2,2,4,4,4,2,2,4,4,3,4,5,5,3,3,4,5,3,2,4,4,2,5,3,2,2,2,2,2,2,2,2,2,1,1,1,1,1,2,1,1,2,1,1,3,3,3,2,4,3,2,3,2,3,4,4,2
260,1,1,1,1,1,2,2,1,3,4,2,3,1,2,3,1,1,3,4,3,2,2,3,1,3,5,2,1,4,2,2,2,3,2,2,1,2,2,2,2,2,4,2,4,5,2,3,4,2,3,2,4,3,2,1,3,3,4,3,3,4,3,3,3,4,3,2,3,4,4,5,4,4,2,5,3,4,5,5,2,4,1,1,2,3,2,1,2,1,2,2,1,1,2,1,1,1,2,1,1,1,1,4,2,4,2,4,3,2,1,3,4,4,3,2
261,1,2,1,1,2,0,2,2,3,2,2,2,1,1,3,2,2,1,3,2,1,2,1,1,2,3,1,2,3,2,3,1,3,2,5,2,2,1,4,5,2,3,2,3,3,1,3,2,2,1,2,1,3,2,3,4,3,4,4,5,5,3,2,2,1,3,5,1,2,3,2,3,1,3,4,5,2,3,2,1,4,3,2,2,3,2,2,2,1,1,2,1,2,2,1,1,1,1,2,2,1,1,4,4,2,2,4,3,1,3,1,4,4,5,2
262,1,3,1,1,1,2,1,1,3,3,2,3,1,2,3,2,2,3,3,2,2,3,3,3,2,2,3,3,3,4,3,3,3,2,3,2,1,2,1,3,4,3,3,5,3,2,2,4,1,1,2,2,2,5,2,4,3,3,3,2,5,4,4,2,3,4,5,4,3,5,3,2,2,3,3,3,4,4,5,2,4,1,1,1,1,2,2,2,1,2,2,1,1,2,1,2,2,2,2,2,2,1,3,3,3,2,3,2,2,4,4,3,4,4,3
263,2,4,1,2,0,0,2,2,4,2,1,4,3,2,3,1,1,3,3,2,2,3,3,3,4,2,2,3,3,4,4,3,3,2,3,5,1,2,1,3,2,3,2,2,4,2,2,4,1,1,2,2,3,2,2,4,3,3,3,2,5,4,4,2,3,4,4,4,3,5,3,2,2,3,3,3,3,4,4,3,4,1,1,1,2,1,1,2,1,2,2,1,1,2,1,2,2,2,2,1,2,1,2,3,2,2,3,2,2,4,4,3,4,5,3
264,2,2,2,1,2,0,1,1,4,3,2,4,1,3,3,2,2,5,4,3,4,2,5,1,3,2,2,5,3,4,3,1,2,3,2,2,1,4,1,3,1,1,3,3,1,1,2,2,1,4,1,1,1,1,1,1,3,1,3,3,2,1,1,1,3,3,2,2,1,4,1,1,1,1,2,3,2,3,3,3,4,4,3,2,2,1,1,1,1,1,1,2,2,1,1,1,2,2,1,1,1,1,2,4,2,3,4,3,3,4,3,2,5,4,4
265,1,2,1,1,1,2,2,2,4,4,2,2,1,1,3,1,1,2,2,2,3,3,5,4,3,4,2,4,2,3,4,1,2,3,4,2,1,1,2,3,1,1,3,3,3,2,2,3,1,1,1,1,1,1,3,3,3,2,3,3,4,4,3,1,3,3,4,4,1,5,3,4,1,2,3,3,2,3,3,3,2,4,3,3,2,1,1,1,2,1,1,2,2,2,1,1,2,2,2,1,1,1,3,4,4,3,4,4,3,4,3,2,4,5,3
266,2,3,1,2,0,0,2,1,4,2,2,3,1,3,3,1,1,4,4,3,2,1,1,1,1,1,1,1,1,3,1,2,2,5,2,3,2,1,2,4,1,2,2,3,3,2,1,2,2,2,3,2,2,3,2,2,3,3,3,4,5,4,3,2,2,2,3,2,3,5,4,1,2,3,2,4,4,3,4,2,3,3,4,5,5,1,1,2,1,1,1,1,1,1,1,1,1,1,1,1,2,1,1,1,1,1,1,1,1,3,4,1,5,5,3
267,1,2,1,2,0,0,1,2,1,1,3,1,2,2,3,2,2,5,5,2,3,2,3,3,2,2,3,1,3,3,2,3,3,3,3,4,2,3,3,3,4,4,3,2,3,1,3,5,2,3,3,3,3,2,3,3,4,2,2,3,3,3,3,3,3,3,4,2,3,4,4,2,3,4,4,3,1,3,4,2,3,4,3,2,2,2,2,2,2,2,2,2,2,2,2,2,2,2,2,2,1,1,4,2,3,2,4,4,3,2,3,2,5,5,2
268,2,1,1,1,1,2,2,1,3,3,2,2,1,1,3,1,1,2,1,1,2,2,3,2,3,2,3,4,2,3,3,1,1,2,3,2,2,2,2,2,2,3,3,2,2,2,2,2,1,2,2,1,3,2,2,4,3,3,2,2,2,5,5,1,1,1,1,1,1,2,2,2,2,3,4,2,2,1,3,4,3,3,4,4,4,2,1,2,1,2,1,1,1,1,1,1,1,2,2,1,1,1,2,1,2,3,5,4,2,3,4,2,5,4,4
269,1,3,3,1,1,2,2,2,4,4,1,4,1,2,3,2,2,2,2,3,2,4,3,3,2,3,4,4,1,3,2,4,2,3,3,3,2,2,2,4,3,1,4,1,3,1,2,3,1,1,1,2,1,1,1,3,3,4,4,3,4,3,4,2,2,5,5,4,1,4,3,1,5,3,1,1,1,3,3,1,5,3,3,2,2,1,1,2,1,1,2,1,1,1,1,1,1,1,2,2,2,2,2,4,3,3,2,1,2,4,3,1,5,5,3
270,1,3,1,1,2,0,1,1,4,3,2,1,1,3,3,1,1,1,1,1,1,1,4,2,4,3,3,1,3,3,3,2,2,1,3,2,2,2,3,4,3,3,2,2,2,1,4,3,2,3,3,3,4,4,5,5,4,3,5,2,2,2,2,1,1,1,1,1,1,1,1,1,1,1,3,2,3,3,4,3,5,3,3,2,2,2,1,1,1,1,1,1,1,1,1,1,1,1,1,1,1,1,1,1,1,1,3,4,2,2,3,2,4,4,2
271,1,2,1,1,1,3,2,1,3,3,2,3,1,1,3,2,2,2,2,1,1,1,3,5,4,4,2,1,2,4,3,3,3,4,4,3,2,5,4,5,3,3,3,2,3,2,2,5,2,4,1,4,4,1,2,2,5,4,4,3,4,4,3,1,5,3,2,5,4,5,4,3,5,4,4,4,4,5,4,4,4,1,1,2,1,2,2,2,1,2,2,1,1,2,1,1,2,2,2,2,1,1,2,3,3,3,4,4,4,4,4,3,3,3,1
272,2,1,1,1,1,2,1,2,3,4,2,3,3,4,3,1,1,2,2,3,1,3,1,1,2,3,2,3,2,3,4,5,2,2,4,2,1,4,1,2,1,2,1,1,3,1,1,2,1,1,1,1,3,4,2,4,5,5,2,5,2,3,5,1,3,2,4,5,2,4,3,3,5,5,4,5,5,5,5,4,5,5,3,5,5,2,1,2,1,2,2,1,1,2,1,1,2,2,1,1,1,1,4,2,4,4,2,3,2,2,4,2,4,4,2
273,1,3,3,1,1,2,2,2,3,4,2,2,1,2,3,2,2,4,4,2,3,2,2,2,5,2,5,5,3,5,5,3,5,4,5,5,2,3,1,3,5,4,5,3,5,4,2,5,1,5,2,3,2,3,4,1,5,4,3,2,4,3,2,1,3,5,5,5,5,5,3,2,5,5,5,5,3,5,5,5,4,5,2,3,1,2,2,2,1,1,2,2,1,2,1,1,2,2,2,2,1,1,5,3,3,5,4,3,3,5,2,3,5,4,3
274,1,2,1,2,0,0,2,1,3,2,2,3,1,1,3,1,2,3,2,1,3,4,1,1,1,1,1,1,2,1,4,3,2,2,2,2,2,3,1,3,2,3,2,5,5,2,1,2,1,1,1,2,2,2,1,2,1,2,1,1,3,3,3,1,1,2,2,2,4,3,1,1,3,4,3,5,2,2,1,2,5,5,1,5,5,2,2,2,2,2,2,1,2,2,1,1,1,2,2,1,1,1,3,2,2,2,4,4,3,4,3,3,2,2,2
275,1,5,1,3,0,0,1,2,3,2,2,1,1,2,3,1,1,3,2,2,1,5,2,1,1,1,2,2,2,5,2,5,2,5,1,5,1,5,3,2,3,3,3,3,5,1,1,1,3,1,1,1,1,1,1,4,4,4,5,3,2,2,2,1,1,3,3,5,5,3,4,4,5,4,4,4,3,5,5,3,4,5,1,5,5,2,2,2,1,2,2,2,2,2,1,1,2,2,2,1,2,1,3,1,2,5,4,4,3,3,4,2,4,5,2
276,1,1,1,2,0,0,2,1,4,2,1,4,1,2,3,1,2,5,1,4,5,5,5,3,4,4,5,2,5,5,5,3,3,5,2,5,4,4,5,4,2,3,3,5,5,2,5,1,5,5,5,3,3,1,5,4,5,5,5,5,5,2,3,3,5,4,4,2,4,4,5,5,2,2,5,5,2,5,5,5,5,5,5,1,3,2,2,2,2,1,1,1,1,2,1,1,1,2,2,1,2,1,5,2,3,1,5,5,1,3,3,4,5,5,2
277,2,2,2,2,0,0,2,1,4,2,2,2,1,1,3,1,1,3,5,2,5,2,5,1,3,1,2,3,4,5,5,5,4,3,2,5,5,3,2,1,2,3,1,1,4,1,4,5,3,1,2,4,3,1,1,3,5,5,4,3,5,5,5,1,3,5,5,5,5,4,3,3,2,4,5,2,1,3,3,2,5,3,3,5,5,1,2,2,1,1,2,1,1,1,2,1,2,2,1,1,1,1,2,2,2,3,4,3,2,2,4,2,5,5,3
278,1,5,1,1,1,3,1,2,4,4,2,3,1,3,4,2,2,2,2,2,2,3,4,1,2,2,5,2,1,3,3,2,3,2,3,2,2,4,4,4,2,2,2,2,2,2,3,3,2,2,2,2,2,2,2,3,2,2,3,3,3,3,3,3,3,3,3,3,3,2,3,3,3,3,3,3,3,3,3,3,3,3,2,3,3,1,1,2,1,1,1,1,2,1,1,1,1,1,1,1,1,1,2,2,2,2,2,2,3,1,3,2,1,1,3
279,1,2,1,1,1,2,1,1,3,3,2,1,1,2,4,1,1,4,5,2,5,4,4,2,3,4,1,1,5,5,4,4,1,2,4,2,2,5,4,3,3,5,2,2,2,2,3,4,2,4,1,3,3,2,1,4,2,1,4,1,3,3,3,3,3,3,4,5,1,5,3,5,5,3,3,5,1,3,3,2,5,5,5,1,1,1,2,2,2,1,2,2,1,2,1,1,2,2,2,1,2,1,5,4,5,4,4,3,2,3,5,3,4,3,5
280,2,1,1,4,0,0,1,2,2,1,3,1,2,1,4,1,1,5,4,2,2,1,1,1,5,2,3,5,3,1,1,1,4,2,4,2,3,3,5,3,2,2,4,2,5,3,4,3,2,3,2,2,2,2,3,2,4,4,4,3,4,4,4,2,4,3,4,3,3,4,4,4,3,4,4,4,3,4,4,4,4,3,2,2,2,2,2,2,2,1,2,2,1,2,2,1,2,2,1,1,1,1,2,3,3,4,4,4,2,2,3,2,5,5,2
281,1,3,3,1,2,0,2,2,4,3,1,4,1,4,4,1,1,3,3,2,3,2,4,2,4,4,3,3,3,2,4,4,3,3,2,3,2,2,1,2,3,3,3,3,4,2,2,2,2,3,2,4,3,2,3,2,3,4,4,2,4,4,4,2,3,4,4,4,4,3,2,4,4,3,5,3,2,4,4,3,4,2,2,2,2,2,1,2,1,1,2,1,1,2,1,1,2,2,2,2,2,1,4,4,4,4,3,4,3,2,3,3,3,4,2
282,1,2,1,1,1,2,2,2,3,4,2,3,1,2,4,2,2,3,3,3,2,1,1,3,2,2,3,3,3,3,4,3,3,3,3,3,2,2,2,3,3,2,3,1,3,2,2,2,4,1,1,1,1,1,2,2,2,2,3,2,2,3,3,4,2,1,1,3,2,2,3,3,3,3,3,3,4,4,2,2,2,3,4,3,3,2,1,1,1,2,2,2,2,2,1,1,2,2,2,2,1,2,2,1,2,3,4,4,2,3,3,1,4,5,3
283,2,4,1,2,0,0,1,2,3,2,2,2,3,1,4,1,1,5,5,5,5,3,3,2,3,3,4,5,4,2,1,3,3,3,5,4,2,5,3,2,5,4,4,3,5,5,3,3,3,3,2,2,2,1,3,3,3,3,3,3,3,5,3,1,1,3,1,5,5,3,3,3,5,3,3,3,3,5,3,3,5,3,4,2,2,2,2,1,1,2,2,2,2,2,1,1,2,2,2,2,1,1,2,3,3,4,4,4,4,2,4,3,5,5,3
284,2,1,1,1,1,2,2,2,3,4,2,1,1,4,4,1,1,3,2,1,3,3,3,1,3,3,5,5,5,3,1,5,5,4,2,1,3,5,1,3,1,3,3,3,3,1,2,3,1,1,1,3,4,2,2,2,4,4,3,2,4,3,3,5,4,2,4,1,5,5,1,3,5,4,5,3,3,3,4,4,4,4,3,2,1,2,1,1,1,1,2,1,2,2,1,1,1,2,1,2,1,1,4,5,2,1,5,4,5,4,2,1,5,5,2
285,1,4,2,2,0,0,1,2,3,2,2,3,1,2,4,2,1,2,2,1,4,3,5,4,5,3,1,4,2,4,2,1,4,3,5,3,1,3,1,3,1,2,3,2,5,2,3,4,1,3,3,3,3,2,5,5,3,2,3,3,2,4,3,1,3,3,4,5,4,4,3,3,3,3,4,2,3,3,3,5,1,1,1,1,3,1,1,1,1,1,2,1,1,2,1,1,2,2,2,2,1,1,3,4,4,4,4,5,2,4,4,3,4,5,4
286,1,1,1,1,2,0,1,1,3,3,1,2,1,1,4,1,2,3,3,2,3,3,4,2,3,4,4,1,3,3,3,1,2,3,3,2,2,4,2,2,2,2,2,1,3,2,3,2,3,4,4,4,4,2,2,2,4,4,4,3,1,2,4,3,4,4,4,3,2,4,2,3,3,4,4,3,2,4,3,3,4,4,2,2,1,2,2,1,1,2,2,2,1,1,2,1,2,2,2,2,1,1,4,3,5,4,4,4,5,3,4,5,5,5,4
287,2,3,1,1,1,2,2,2,1,1,3,3,2,3,4,1,1,3,3,2,3,5,5,4,3,4,2,4,4,4,3,5,3,2,2,3,5,3,1,5,3,4,4,3,4,1,2,5,2,3,1,5,4,2,3,2,2,3,4,3,3,2,2,3,3,2,2,1,4,2,3,4,2,4,4,2,2,5,5,4,5,1,4,1,2,2,1,2,1,1,2,1,2,2,1,2,1,1,1,1,2,2,3,4,4,5,4,2,2,3,4,3,3,3,3
288,1,2,1,2,0,0,1,1,4,2,2,3,1,2,4,1,1,2,3,2,5,3,4,5,2,1,2,2,2,4,2,3,2,2,1,2,2,4,1,3,1,2,3,2,2,1,2,2,1,5,3,2,5,1,2,1,4,4,2,3,3,4,3,1,1,1,2,4,3,5,3,4,1,4,3,4,1,4,4,2,3,5,2,1,4,2,2,2,1,1,1,1,1,2,1,1,1,1,1,1,1,1,1,1,1,5,5,3,3,3,2,1,5,4,4
289,1,1,1,2,0,0,2,2,4,2,2,1,1,1,4,2,2,4,4,5,5,4,3,2,2,3,1,4,4,2,5,3,5,3,2,3,3,1,1,3,3,3,4,5,5,1,2,4,3,4,3,5,4,2,3,3,3,5,2,2,4,4,4,2,2,4,4,3,4,5,5,3,3,4,5,3,2,4,4,2,5,3,2,2,2,2,2,2,2,2,2,1,1,1,1,1,2,1,1,2,1,1,3,3,2,2,4,3,3,3,2,3,4,4,2
290,2,4,3,2,0,0,1,1,4,2,1,4,1,4,4,1,2,3,4,3,2,2,3,1,3,5,2,3,4,2,2,2,3,2,2,1,2,2,2,2,2,4,2,4,5,2,3,4,2,3,2,4,3,2,1,3,3,4,3,3,4,3,3,3,4,3,2,3,4,4,5,4,4,2,5,3,4,5,5,2,4,1,1,2,3,2,1,2,1,2,2,1,1,2,1,1,1,2,1,1,1,1,4,2,4,2,4,3,2,1,3,4,4,3,2
291,1,1,1,2,0,0,1,2,3,2,2,1,1,2,4,1,1,1,3,2,1,2,1,1,2,3,1,2,3,2,3,4,3,2,5,2,2,1,4,5,4,3,2,3,3,1,3,2,2,1,2,1,3,2,3,4,3,4,4,5,5,3,2,2,1,3,5,1,2,3,2,3,1,3,4,5,2,3,2,1,4,3,2,2,3,2,2,2,1,1,2,1,2,2,1,1,1,1,2,2,1,1,4,4,2,2,4,3,1,3,1,4,4,5,2
292,1,4,1,2,0,0,1,1,3,2,2,3,1,1,4,2,2,3,3,2,2,3,3,3,2,2,3,3,3,4,3,3,1,2,3,2,1,2,1,3,2,3,3,3,3,2,2,4,1,1,2,2,2,5,2,4,3,3,3,2,5,4,4,2,3,4,5,4,3,5,3,2,2,3,3,3,4,4,5,2,4,1,1,1,1,2,2,2,1,2,2,1,1,2,1,2,2,2,2,2,2,1,3,3,3,2,3,2,2,4,4,3,4,4,3
293,1,2,1,1,1,3,1,2,3,4,2,2,1,3,4,1,1,3,3,2,2,3,3,3,4,2,2,1,3,4,4,3,3,2,3,5,1,2,1,3,2,3,2,2,4,2,2,4,1,1,2,2,3,2,2,4,3,3,3,2,5,4,4,2,3,4,4,4,3,5,3,2,2,3,3,3,3,4,4,3,4,1,1,1,2,1,1,2,1,2,2,1,1,2,1,2,2,2,2,1,2,1,2,3,3,2,3,2,2,4,4,3,4,5,3
294,1,1,3,2,0,0,1,1,3,2,1,4,1,4,4,2,2,5,4,3,4,2,5,1,3,2,2,5,3,4,3,1,2,3,2,2,1,4,1,3,1,1,3,3,1,1,2,2,1,4,1,1,1,1,1,1,3,1,3,3,2,1,1,1,3,3,2,2,1,4,1,1,1,1,2,3,2,3,3,3,4,4,3,2,2,1,1,1,1,1,1,2,2,1,1,1,2,2,1,1,1,1,2,4,2,3,4,3,3,4,3,2,5,4,4
295,2,1,1,2,0,0,1,1,2,1,3,3,1,1,4,1,1,2,2,2,3,3,5,4,3,4,2,4,2,3,4,1,2,3,4,2,1,1,2,3,1,1,3,3,3,2,2,3,1,1,1,1,1,1,3,3,3,2,3,3,4,4,3,1,3,3,4,4,1,5,3,4,1,2,3,3,2,3,3,3,2,4,3,3,2,1,1,1,2,1,1,2,2,2,1,1,2,2,2,1,1,1,3,4,4,2,4,4,2,4,3,2,4,5,3
296,1,3,1,1,1,1,1,2,4,3,2,3,2,3,4,1,1,4,4,3,2,1,1,1,1,1,1,1,1,3,1,2,2,5,2,3,2,1,2,4,1,2,2,5,3,2,1,2,2,2,3,2,2,3,2,2,3,3,3,4,5,4,3,2,2,2,3,2,3,5,4,1,2,3,2,4,4,3,4,2,3,3,4,5,5,1,1,2,1,1,1,1,1,1,1,1,1,1,1,1,2,1,1,1,1,1,1,1,1,3,4,1,5,5,3
297,1,4,1,4,0,0,1,2,3,2,2,2,1,2,4,2,2,5,5,2,3,2,3,3,2,2,3,3,3,3,2,3,3,3,3,4,2,3,3,3,4,4,3,2,3,1,3,5,2,3,3,3,3,2,3,3,4,2,2,3,3,3,3,3,3,3,4,2,3,4,4,2,3,4,4,3,1,3,4,2,3,4,3,2,2,2,2,2,2,2,2,2,2,2,2,2,2,2,2,2,1,1,4,3,3,2,4,4,3,2,3,2,5,5,2
298,2,2,1,2,0,0,2,2,4,2,1,4,2,1,4,1,1,2,1,1,2,2,3,2,3,2,3,4,2,3,3,1,1,2,3,2,2,2,2,2,2,3,3,2,2,2,2,2,1,2,2,1,3,2,2,4,3,3,2,2,2,5,5,1,1,1,1,1,1,2,2,2,2,3,4,2,2,1,3,4,3,3,4,4,4,2,1,2,1,2,1,1,1,1,1,1,1,2,2,1,1,1,2,1,2,2,5,4,2,3,4,2,5,4,4
299,1,2,1,1,1,2,2,1,3,4,2,1,1,3,4,1,1,2,2,3,2,4,3,3,2,3,4,4,1,3,2,4,2,3,3,3,2,2,2,4,3,1,4,1,3,1,2,3,1,1,1,2,1,1,1,3,3,4,4,3,4,3,4,2,2,5,5,4,1,4,3,1,5,3,1,1,1,3,3,1,5,3,3,2,2,1,1,2,1,1,2,1,1,1,1,1,1,1,2,2,2,2,2,4,3,2,2,1,3,4,3,1,5,5,3
300,1,4,2,2,0,0,1,1,3,2,2,3,1,2,4,1,1,1,1,1,1,1,4,2,4,3,3,3,3,3,3,2,2,1,3,2,2,2,3,4,3,3,2,2,2,1,4,3,2,3,3,3,4,4,5,5,4,3,5,2,2,2,2,1,1,1,1,1,1,1,1,1,1,1,3,2,3,3,4,3,5,3,3,2,2,2,1,1,1,1,1,1,1,1,1,1,1,1,1,1,1,1,1,1,1,1,3,4,2,2,3,2,4,4,2
301,1,1,1,1,2,0,2,2,3,3,2,1,2,2,4,1,1,2,2,1,1,1,3,5,4,4,2,4,2,4,3,3,3,4,4,3,2,5,4,5,3,3,3,2,3,2,2,5,2,4,1,4,4,1,2,2,5,4,4,3,4,4,3,1,5,3,2,5,4,5,4,3,5,4,4,4,4,5,4,4,4,1,1,2,1,2,2,2,1,2,2,1,1,2,1,1,2,2,2,2,1,1,3,2,3,3,4,4,4,4,4,3,3,3,1
302,2,2,1,2,0,0,1,1,4,2,1,4,1,1,4,1,1,2,2,3,1,3,1,1,2,3,2,3,2,3,4,1,2,2,4,2,1,4,1,2,1,2,1,1,3,1,1,2,1,1,1,1,3,4,2,4,5,5,2,5,2,3,5,1,3,2,4,5,2,4,3,3,5,5,4,5,5,5,5,4,5,5,3,5,5,2,1,2,1,2,2,1,1,2,1,1,2,2,1,1,1,1,4,2,4,4,2,3,2,2,4,2,4,4,2
303,1,1,1,2,0,0,2,2,4,2,2,3,1,4,4,2,2,4,4,2,3,2,2,2,5,2,5,5,3,5,5,3,5,4,5,5,2,3,1,3,5,4,5,3,5,4,2,5,1,5,2,3,2,3,4,1,5,4,3,2,4,3,2,1,3,5,5,5,5,5,3,2,5,5,5,5,3,5,5,5,4,5,2,3,1,2,2,2,1,1,2,2,1,2,1,1,2,2,2,2,1,1,5,3,3,5,4,3,3,5,2,3,5,4,3
304,2,5,1,1,1,2,1,1,4,4,1,2,1,2,4,1,1,3,2,1,3,4,1,1,1,1,1,1,2,1,4,3,2,2,2,2,2,3,1,3,2,3,2,5,5,2,1,2,1,1,1,2,2,2,1,2,1,2,1,1,3,3,3,1,1,2,2,2,4,3,1,1,3,4,3,5,2,2,1,2,5,5,1,5,5,2,2,2,2,2,2,1,2,2,1,1,1,2,2,1,1,1,3,2,2,2,4,4,2,4,3,3,2,2,2
305,1,2,2,2,0,0,1,2,4,2,2,3,1,1,4,1,1,3,2,2,1,5,2,1,1,1,2,2,2,5,2,5,2,5,1,5,1,5,3,2,3,3,3,3,5,1,1,1,3,1,1,1,1,1,1,4,4,4,5,3,2,2,2,1,1,3,3,5,5,3,4,4,5,4,4,4,3,5,5,3,4,5,1,5,5,2,2,2,1,2,2,2,2,2,1,1,2,2,2,1,2,1,3,1,2,5,4,4,3,3,4,2,4,5,2
306,1,3,1,2,0,0,2,1,3,2,2,1,1,3,5,2,2,5,1,4,5,5,5,3,4,4,5,2,5,5,5,3,3,5,2,5,4,4,5,4,2,3,3,3,5,2,5,1,5,5,5,3,3,1,5,4,5,5,5,5,5,2,3,3,5,4,4,2,4,4,5,5,2,2,5,5,2,5,5,5,5,5,5,1,3,2,2,2,2,1,1,1,1,2,1,1,1,2,2,1,2,1,5,2,3,1,5,5,1,3,3,4,5,5,2
307,1,1,1,1,2,0,2,1,3,3,2,3,2,2,5,1,1,3,5,2,5,2,5,1,3,1,2,1,4,5,5,5,4,3,2,5,5,3,2,1,2,3,1,1,4,1,4,5,3,1,2,4,3,1,1,3,5,5,4,3,5,5,5,1,3,5,5,5,5,4,3,3,2,4,5,2,1,3,3,2,5,3,3,5,5,1,2,2,1,1,2,1,1,1,2,1,2,2,1,1,1,1,3,2,2,2,4,3,2,2,4,2,5,5,3
308,1,3,1,1,1,2,1,2,1,1,3,2,1,4,5,2,2,2,2,2,2,3,4,1,2,2,5,2,1,3,3,2,1,2,3,2,2,4,4,4,2,2,2,2,2,2,3,3,2,2,2,2,2,2,2,3,2,2,3,3,3,3,3,3,3,3,3,3,3,2,3,3,3,3,3,3,3,3,3,3,3,3,2,3,3,1,1,2,1,1,1,1,2,1,1,1,1,1,1,1,1,1,2,2,2,3,2,2,3,1,3,2,1,1,3
309,1,2,1,2,0,0,2,2,4,2,1,4,1,2,5,2,2,4,5,2,5,4,4,2,3,4,1,3,5,5,4,4,3,2,4,2,2,5,4,3,3,5,2,2,2,2,3,4,2,4,1,3,3,2,1,4,2,1,4,1,3,3,3,3,3,3,4,5,1,5,3,5,5,3,3,5,1,3,3,2,5,5,5,1,1,1,2,2,2,1,2,2,1,2,1,1,2,2,2,1,2,1,5,4,5,4,4,3,3,3,5,3,4,3,5
310,2,4,1,1,1,2,1,1,3,4,2,4,3,1,5,1,2,5,4,2,2,1,1,1,5,2,3,5,3,1,4,1,4,2,4,2,3,3,5,3,2,2,4,2,5,3,4,3,2,3,2,2,2,2,3,2,4,4,4,3,4,4,4,2,4,3,4,3,3,4,4,4,3,4,4,4,3,4,4,4,4,3,2,2,2,2,2,2,2,1,2,2,1,2,2,1,2,2,1,1,1,1,2,3,3,4,4,4,3,4,3,2,5,5,2
311,1,2,2,2,0,0,2,2,3,2,2,1,1,3,5,1,1,3,3,2,3,2,4,2,4,4,3,3,3,2,4,4,3,3,2,3,2,2,1,2,3,3,3,5,4,2,2,2,2,3,2,4,3,2,3,2,3,4,4,2,4,4,4,2,3,4,4,4,4,3,2,4,4,3,5,3,2,4,4,3,4,2,2,2,2,2,1,2,1,1,2,1,1,2,1,1,2,2,2,2,2,1,4,4,4,4,3,4,3,4,3,3,3,4,2
312,1,1,1,4,0,0,1,1,4,2,1,4,1,2,5,1,1,3,3,3,2,1,1,3,2,2,3,3,3,3,4,3,3,3,3,3,2,2,2,3,3,2,3,1,3,2,2,2,4,1,1,1,1,1,2,2,2,2,3,2,2,3,3,4,2,1,1,3,2,2,3,3,3,3,3,3,4,4,2,2,2,3,4,3,3,2,1,1,1,2,2,2,2,2,1,1,2,2,2,2,1,2,2,1,2,2,4,4,3,3,3,1,4,5,3
313,2,2,1,1,1,1,1,2,3,4,2,4,1,2,5,1,2,5,5,5,5,3,3,2,3,3,4,5,4,2,4,3,3,3,5,4,2,5,3,2,5,4,4,3,5,5,3,3,3,3,2,2,2,1,3,3,3,3,3,3,3,5,3,1,1,3,1,5,5,3,3,3,5,3,3,3,3,5,3,3,5,3,4,2,2,2,2,1,1,2,2,2,2,2,1,1,2,2,2,2,1,1,2,2,3,4,4,4,4,2,4,3,5,5,3
314,1,3,1,2,0,0,2,2,3,2,2,3,1,1,5,1,1,3,2,1,3,3,3,1,3,3,5,5,5,3,1,5,5,4,2,1,3,5,1,3,1,3,3,3,3,1,2,3,1,1,1,3,4,2,2,2,4,4,3,2,4,3,3,5,4,2,4,1,5,5,1,3,5,4,5,3,3,3,4,4,4,4,3,2,1,2,1,1,1,1,2,1,2,2,1,1,1,2,1,2,1,1,4,5,2,1,5,4,5,4,2,1,5,5,2
315,2,2,1,2,0,0,1,1,3,1,2,1,1,3,5,2,2,2,2,1,4,3,5,4,5,3,1,4,2,4,2,4,4,3,5,3,1,3,1,3,1,2,3,2,5,2,3,4,1,3,3,3,3,2,5,5,3,2,3,3,2,4,3,1,3,3,4,5,4,4,3,3,3,3,4,2,3,3,3,5,1,1,1,1,3,1,1,1,1,1,2,1,1,2,1,1,2,2,2,2,1,1,3,4,4,4,4,5,2,4,4,3,4,5,4
316,1,1,2,2,0,0,2,2,2,1,3,2,2,2,5,1,1,3,3,2,3,3,4,2,3,4,4,4,3,3,3,1,2,3,3,2,2,4,2,2,2,2,2,1,3,2,3,2,3,4,4,4,4,2,2,2,4,4,4,3,1,2,4,3,4,4,4,3,2,4,2,3,3,4,4,3,2,4,3,3,4,4,2,2,1,2,2,1,1,2,2,2,1,1,2,1,2,2,2,2,1,1,4,3,5,4,4,4,5,3,4,5,5,5,4
317,1,2,1,2,0,0,2,1,3,2,2,3,1,4,5,1,1,3,3,2,3,5,5,4,3,4,2,4,4,4,3,5,3,2,2,3,5,3,1,5,3,4,4,3,4,1,2,5,2,3,1,5,4,2,3,2,2,3,4,3,3,2,2,3,3,2,2,1,4,2,3,4,2,4,4,2,2,5,5,4,5,1,4,1,2,2,1,2,1,1,2,1,2,2,1,2,1,1,1,1,2,2,2,4,4,5,4,2,2,3,4,3,3,3,3
318,2,4,1,1,1,3,2,1,3,4,2,1,1,1,5,2,2,2,3,2,5,3,4,5,2,1,2,2,2,4,2,3,2,2,1,2,2,4,1,3,1,2,3,2,2,1,2,2,1,5,3,2,5,1,2,1,4,4,2,3,3,4,3,1,1,1,2,4,3,5,3,4,1,4,3,4,1,4,4,2,3,5,2,1,4,2,2,2,1,1,1,1,1,2,1,1,1,1,1,1,1,1,1,1,1,5,5,3,3,3,2,1,5,4,4
319,1,2,1,2,0,0,1,2,4,2,1,4,1,4,5,1,1,4,4,5,5,4,3,2,2,3,1,4,4,2,5,3,5,3,2,3,3,1,1,3,3,3,4,3,5,1,2,4,3,4,3,5,4,2,3,3,3,5,2,2,4,4,4,2,2,4,4,3,4,5,5,3,3,4,5,3,2,4,4,2,5,3,2,2,2,2,2,2,2,2,2,1,1,1,1,1,2,1,1,2,1,1,3,3,3,2,4,3,2,3,2,3,4,4,2
320,1,3,1,2,0,0,2,1,3,2,2,3,1,2,5,1,1,3,4,3,2,2,3,1,3,5,2,1,4,2,2,2,3,2,2,1,2,2,2,2,2,4,2,4,5,2,3,4,2,3,2,4,3,2,1,3,3,4,3,3,4,3,3,3,4,3,2,3,4,4,5,4,4,2,5,3,4,5,5,2,4,1,1,2,3,2,1,2,1,2,2,1,1,2,1,1,1,2,1,1,1,1,4,2,4,2,4,3,2,1,3,4,4,3,2
321,1,3,1,1,2,0,2,2,3,3,2,1,1,1,5,2,2,1,3,2,1,2,1,1,2,3,1,2,3,2,3,4,3,2,5,2,2,1,4,5,2,3,2,3,3,1,3,2,2,1,2,1,3,2,3,4,3,4,4,5,5,3,2,2,1,3,5,1,2,3,2,3,1,3,4,5,2,3,2,1,4,3,2,2,3,2,2,2,1,1,2,1,2,2,1,1,1,1,2,2,1,1,4,4,2,2,4,3,1,3,1,4,4,5,2
322,2,2,2,1,1,3,2,2,3,3,2,3,1,3,5,1,1,3,3,2,2,3,3,3,2,2,3,3,3,4,3,3,3,2,3,2,1,2,1,3,2,3,3,3,3,2,2,4,1,1,2,2,2,5,2,4,3,3,3,2,5,4,4,2,3,4,5,4,3,5,3,2,2,3,3,3,4,4,5,2,4,1,1,1,1,2,2,2,1,2,2,1,1,2,1,2,2,2,2,2,2,1,2,3,3,2,3,2,2,4,4,3,4,4,3
323,2,4,1,1,1,2,1,1,4,4,1,4,2,2,5,1,1,3,3,2,2,3,3,3,4,2,2,3,3,4,4,3,3,2,3,5,1,2,1,3,4,3,2,2,4,2,2,4,1,1,2,2,3,2,2,4,3,3,3,2,5,4,4,2,3,4,4,4,3,5,3,2,2,3,3,3,3,4,4,3,4,1,1,1,2,1,1,2,1,2,2,1,1,2,1,2,2,2,2,1,2,1,2,2,3,2,3,2,2,4,4,3,4,5,3
324,1,2,1,2,0,0,2,2,3,2,2,1,1,1,5,2,2,5,4,3,4,2,5,1,3,2,2,5,3,4,3,1,2,3,2,2,1,4,1,3,1,1,3,5,1,1,2,2,1,4,1,1,1,1,1,1,3,1,3,3,2,1,1,1,3,3,2,2,1,4,1,1,1,1,2,3,2,3,3,3,4,4,3,2,2,1,1,1,1,1,1,2,2,1,1,1,2,2,1,1,1,1,2,4,2,2,4,3,3,4,3,2,5,4,4
325,1,2,1,1,1,2,1,1,3,3,2,2,1,3,5,1,1,2,2,2,3,3,5,4,3,4,2,4,2,3,4,1,2,3,4,2,1,1,2,3,1,1,3,3,3,2,2,3,1,1,1,1,1,1,3,3,3,2,3,3,4,4,3,1,3,3,4,4,1,5,3,4,1,2,3,3,2,3,3,3,2,4,3,3,2,1,1,1,2,1,1,2,2,2,1,1,2,2,2,1,1,1,3,4,4,2,4,4,3,4,3,2,4,5,3
326,1,4,1,2,0,0,1,2,3,2,2,3,1,2,5,2,2,4,4,3,2,1,1,1,1,1,1,1,1,3,1,2,2,5,2,3,2,1,2,4,1,2,2,3,3,2,1,2,2,2,3,2,2,3,2,2,3,3,3,4,5,4,3,2,2,2,3,2,3,5,4,1,2,3,2,4,4,3,4,2,3,3,4,5,5,1,1,2,1,1,1,1,1,1,1,1,1,1,1,1,2,1,1,1,1,1,1,1,1,3,4,1,5,5,3
327,1,2,1,2,0,0,2,1,3,2,2,1,1,1,5,1,2,5,5,2,3,2,3,3,2,2,3,3,3,3,2,3,3,3,3,4,2,3,3,3,4,4,3,2,3,1,3,5,2,3,3,3,3,2,3,3,4,2,2,3,3,3,3,3,3,3,4,2,3,4,4,2,3,4,4,3,1,3,4,2,3,4,3,2,2,2,2,2,2,2,2,2,2,2,2,2,2,2,2,2,1,1,4,2,3,2,4,4,3,2,3,2,5,5,2
328,1,3,1,2,0,0,2,1,1,1,3,3,2,4,5,1,1,2,1,1,2,2,3,2,3,2,3,1,2,3,3,1,1,2,3,2,2,2,2,2,2,3,3,2,2,2,2,2,1,2,2,1,3,2,2,4,3,3,2,2,2,5,5,1,1,1,1,1,1,2,2,2,2,3,4,2,2,1,3,4,3,3,4,4,4,2,1,2,1,2,1,1,1,1,1,1,1,2,2,1,1,1,2,1,2,3,5,4,2,3,4,2,5,4,4
329,1,2,3,2,0,0,1,2,4,2,2,2,1,2,5,1,1,2,2,3,2,4,3,3,2,3,4,4,1,3,2,4,2,3,3,3,2,2,2,4,3,1,4,1,3,1,2,3,1,1,1,2,1,1,1,3,3,4,4,3,4,3,4,2,2,5,5,4,1,4,3,1,5,3,1,1,1,3,3,1,5,3,3,2,2,1,1,2,1,1,2,1,1,1,1,1,1,1,2,2,2,2,2,4,3,2,2,1,3,4,3,1,5,5,3
330,2,1,1,1,1,2,2,1,4,4,1,4,1,3,5,1,1,1,1,1,1,1,4,2,4,3,3,3,3,3,3,2,2,1,3,2,2,2,3,4,3,3,2,2,2,1,4,3,2,3,3,3,4,4,5,5,4,3,5,2,2,2,2,1,1,1,1,1,1,1,1,1,1,1,3,2,3,3,4,3,5,3,3,2,2,2,1,1,1,1,1,1,1,1,1,1,1,1,1,1,1,1,1,1,1,1,3,4,2,2,3,2,4,4,2
331,1,3,1,2,0,0,1,2,3,2,2,4,1,1,5,1,1,2,2,1,1,1,3,5,4,4,2,4,2,4,3,3,3,4,4,3,2,5,4,5,3,3,3,2,3,2,2,5,2,4,1,4,4,1,2,2,5,4,4,3,4,4,3,1,5,3,2,5,4,5,4,3,5,4,4,4,4,5,4,4,4,1,1,2,1,2,2,2,1,2,2,1,1,2,1,1,2,2,2,2,1,1,3,3,3,3,4,4,4,4,4,3,3,3,1
332,1,2,1,1,1,1,2,1,3,4,2,2,1,4,6,2,2,2,2,3,1,3,1,1,2,3,2,3,2,3,4,5,2,2,4,2,1,4,1,2,1,2,1,1,3,1,1,2,1,1,1,1,3,4,2,4,5,5,2,5,2,3,5,1,3,2,4,5,2,4,3,3,5,5,4,5,5,5,5,4,5,5,3,5,5,2,1,2,1,2,2,1,1,2,1,1,2,2,1,1,1,1,4,2,4,4,2,3,2,2,4,2,4,4,2
333,2,2,2,2,0,0,1,1,4,2,2,3,1,2,6,1,2,4,4,2,3,2,2,2,5,2,5,5,3,5,5,3,5,4,5,5,2,3,1,3,5,4,5,3,5,4,2,5,1,5,2,3,2,3,4,1,5,4,3,2,4,3,2,1,3,5,5,5,5,5,3,2,5,5,5,5,3,5,5,5,4,5,2,3,1,2,2,2,1,1,2,2,1,2,1,1,2,2,2,2,1,1,5,2,3,5,4,3,3,5,2,3,5,4,3
334,1,3,1,1,2,0,2,2,3,3,2,2,1,2,6,1,1,3,2,1,3,4,1,1,1,1,1,1,2,1,4,3,2,2,2,2,2,3,1,3,2,3,2,5,5,2,1,2,1,1,1,2,2,2,1,2,1,2,1,1,3,3,3,1,1,2,2,2,4,3,1,1,3,4,3,5,2,2,1,2,5,5,1,5,5,2,2,2,2,2,2,1,2,2,1,1,1,2,2,1,1,1,3,2,2,2,4,4,2,4,3,3,2,2,2
335,1,2,1,1,1,3,1,1,4,3,1,4,1,3,6,2,2,3,2,2,1,5,2,1,1,1,2,2,2,5,2,5,2,5,1,5,1,5,3,2,3,3,3,3,5,1,1,1,3,1,1,1,1,1,1,4,4,4,5,3,2,2,2,1,1,3,3,5,5,3,4,4,5,4,4,4,3,5,5,3,4,5,1,5,5,2,2,2,1,2,2,2,2,2,1,1,2,2,2,1,2,1,2,1,2,5,4,4,2,3,4,2,4,5,2
336,1,3,1,1,1,3,2,1,3,4,2,3,1,2,6,1,1,5,1,4,5,5,5,3,4,4,5,2,5,5,5,3,3,5,2,5,4,4,5,4,2,3,3,3,5,2,5,1,5,5,5,3,3,1,5,4,5,5,5,5,5,2,3,3,5,4,4,2,4,4,5,5,2,2,5,5,2,5,5,5,5,5,5,1,3,2,2,2,2,1,1,1,1,2,1,1,1,2,2,1,2,1,5,2,3,1,5,5,1,3,3,4,5,5,2
337,2,3,1,2,0,0,1,2,2,1,3,1,2,4,6,1,1,3,5,2,5,2,5,1,3,1,2,3,4,5,5,5,4,3,2,5,5,3,2,1,2,3,1,1,4,1,4,5,3,1,2,4,3,1,1,3,5,5,4,3,5,5,5,1,3,5,5,5,5,4,3,3,2,4,5,2,1,3,3,2,5,3,3,5,5,1,2,2,1,1,2,1,1,1,2,1,2,2,1,1,1,1,2,2,2,2,4,3,2,2,4,2,5,5,3
338,1,2,1,2,0,0,2,2,3,2,2,3,1,2,6,2,2,2,2,2,2,3,4,1,2,2,5,2,1,3,3,2,3,2,3,2,2,4,4,4,2,2,2,2,2,2,3,3,2,2,2,2,2,2,2,3,2,2,3,3,3,3,3,3,3,3,3,3,3,2,3,3,3,3,3,3,3,3,3,3,3,3,2,3,3,1,1,2,1,1,1,1,2,1,1,1,1,1,1,1,1,1,2,2,2,2,2,2,3,1,3,2,1,1,3
339,1,1,1,1,1,2,1,2,3,3,1,4,1,1,6,1,2,4,5,2,5,4,4,2,3,4,1,1,5,5,4,4,3,2,4,2,2,5,4,3,3,5,2,2,2,2,3,4,2,4,1,3,3,2,1,4,2,1,4,1,3,3,3,3,3,3,4,5,1,5,3,5,5,3,3,5,1,3,3,2,5,5,5,1,1,1,2,2,2,1,2,2,1,2,1,1,2,2,2,1,2,1,5,4,5,4,4,3,3,3,5,3,4,3,5
340,2,4,2,2,0,0,2,1,3,2,2,2,1,4,6,1,2,5,4,2,2,1,1,1,5,2,3,5,3,1,4,1,4,2,4,2,3,3,5,3,2,2,4,2,5,3,4,3,2,3,2,2,2,2,3,2,4,4,4,3,4,4,4,2,4,3,4,3,3,4,4,4,3,4,4,4,3,4,4,4,4,3,2,2,2,2,2,2,2,1,2,2,1,2,2,1,2,2,1,1,1,1,2,3,3,4,4,4,3,4,3,2,5,5,2
341,1,2,1,1,1,3,1,2,2,1,3,4,2,2,6,2,2,3,3,2,3,2,4,2,4,4,3,3,3,2,4,1,3,3,2,3,2,2,1,2,3,3,3,3,4,2,2,2,2,3,2,4,3,2,3,2,3,4,4,2,4,4,4,2,3,4,4,4,4,3,2,4,4,3,5,3,2,4,4,3,4,2,2,2,2,2,1,2,1,1,2,1,1,2,1,1,2,2,2,2,2,1,4,4,4,4,3,4,3,4,3,3,3,4,2
342,2,4,1,2,0,0,2,2,4,2,2,1,1,2,6,1,1,3,3,3,2,1,1,3,2,2,3,3,3,3,4,3,3,3,3,3,2,2,2,3,3,2,3,1,3,2,2,2,4,1,1,1,1,1,2,2,2,2,3,2,2,3,3,4,2,1,1,3,2,2,3,3,3,3,3,3,4,4,2,2,2,3,4,3,3,2,1,1,1,2,2,2,2,2,1,1,2,2,2,2,1,2,2,1,2,3,4,4,3,3,3,1,4,5,3
343,1,2,1,1,1,2,2,2,4,3,1,4,1,2,6,1,1,5,5,5,5,3,3,2,3,3,4,5,4,2,4,3,3,3,5,4,2,5,3,2,5,4,4,3,5,5,3,3,3,3,2,2,2,1,3,3,3,3,3,3,3,5,3,1,1,3,1,5,5,3,3,3,5,3,3,3,3,5,3,3,5,3,4,2,2,2,2,1,1,2,2,2,2,2,1,1,2,2,2,2,1,1,2,3,3,4,4,4,4,2,4,3,5,5,3
344,2,3,1,1,1,2,1,1,3,4,2,2,1,4,6,1,1,3,2,1,3,3,3,1,3,3,5,5,5,3,1,5,5,4,2,1,3,5,1,3,1,3,3,3,3,1,2,3,1,1,1,3,4,2,2,2,4,4,3,2,4,3,3,5,4,2,4,1,5,5,1,3,5,4,5,3,3,3,4,4,4,4,3,2,1,2,1,1,1,1,2,1,2,2,1,1,1,2,1,2,1,1,4,5,2,1,5,4,5,4,2,1,5,5,2
345,1,2,3,1,1,2,2,2,3,3,2,4,1,2,6,1,2,2,2,1,4,3,5,4,5,3,1,4,2,4,2,4,4,3,5,3,1,3,1,3,1,2,3,2,5,2,3,4,1,3,3,3,3,2,5,5,3,2,3,3,2,4,3,1,3,3,4,5,4,4,3,3,3,3,4,2,3,3,3,5,1,1,1,1,3,1,1,1,1,1,2,1,1,2,1,1,2,2,2,2,1,1,3,4,4,4,4,5,2,2,4,3,4,5,4
346,1,1,1,2,0,0,1,1,3,2,2,1,1,3,6,1,1,3,3,2,3,3,4,2,3,4,4,4,3,3,3,1,2,3,3,2,2,4,2,2,2,2,2,1,3,2,3,2,3,4,4,4,4,2,2,2,4,4,4,3,1,2,4,3,4,4,4,3,2,4,2,3,3,4,4,3,2,4,3,3,4,4,2,2,1,2,2,1,1,2,2,2,1,1,2,1,2,2,2,2,1,1,4,3,5,4,4,4,5,3,4,5,5,5,4
347,2,4,1,2,0,0,2,1,4,2,1,4,1,2,6,1,1,3,3,2,3,5,5,4,3,4,2,4,4,4,3,5,1,2,2,3,5,3,1,5,3,4,4,3,4,1,2,5,2,3,1,5,4,2,3,2,2,3,4,3,3,2,2,3,3,2,2,1,4,2,3,4,2,4,4,2,2,5,5,4,5,1,4,1,2,2,1,2,1,1,2,1,2,2,1,2,1,1,1,1,2,2,3,4,4,5,4,2,2,3,4,3,3,3,3
348,1,2,1,1,1,3,1,2,3,3,2,4,1,1,6,2,2,2,3,2,5,3,4,5,2,1,2,2,2,4,2,3,2,2,1,2,2,4,1,3,1,2,3,2,2,1,2,2,1,5,3,2,5,1,2,1,4,4,2,3,3,4,3,1,1,1,2,4,3,5,3,4,1,4,3,4,1,4,4,2,3,5,2,1,4,2,2,2,1,1,1,1,1,2,1,1,1,1,1,1,1,1,1,1,1,5,5,3,3,3,2,1,5,4,4
349,1,3,1,2,0,0,1,1,3,2,2,2,1,2,6,1,1,4,4,5,5,4,3,2,2,3,1,4,4,2,5,3,5,3,2,3,3,1,1,3,3,3,4,3,5,1,2,4,3,4,3,5,4,2,3,3,3,5,2,2,4,4,4,2,2,4,4,3,4,5,5,3,3,4,5,3,2,4,4,2,5,3,2,2,2,2,2,2,2,2,2,1,1,1,1,1,2,1,1,2,1,1,3,3,2,2,4,3,2,3,2,3,4,4,2
350,2,4,2,1,1,3,2,1,1,1,3,1,2,2,6,1,1,3,4,3,2,2,3,1,3,5,2,3,4,2,2,2,3,2,2,1,2,2,2,2,2,4,2,4,5,2,3,4,2,3,2,4,3,2,1,3,3,4,3,3,4,3,3,3,4,3,2,3,4,4,5,4,4,2,5,3,4,5,5,2,4,1,1,2,3,2,1,2,1,2,2,1,1,2,1,1,1,2,1,1,1,1,4,2,4,2,4,3,2,1,3,4,4,3,2
351,1,2,1,2,0,0,1,2,2,2,2,4,1,4,6,1,2,1,3,2,1,2,1,1,2,3,1,2,3,2,3,4,3,2,5,2,2,1,4,5,4,3,2,3,3,1,3,2,2,1,2,1,3,2,3,4,3,4,4,5,5,3,2,2,1,3,5,1,2,3,2,3,1,3,4,5,2,3,2,1,4,3,2,2,3,2,2,2,1,1,2,1,2,2,1,1,1,1,2,2,1,1,4,4,2,2,4,3,1,3,1,4,4,5,2
352,1,3,1,1,2,0,2,2,4,3,1,4,1,2,6,2,2,3,3,2,2,3,3,3,2,2,3,3,3,4,3,1,3,2,3,2,1,2,1,3,2,3,3,3,3,2,2,4,1,1,2,2,2,5,2,4,3,3,3,2,5,4,4,2,3,4,5,4,3,5,3,2,2,3,3,3,4,4,5,2,4,1,1,1,1,2,2,2,1,2,2,1,1,2,1,2,2,2,2,2,2,1,2,3,3,2,3,2,2,4,4,3,4,4,3
353,2,2,3,1,1,3,2,2,4,4,2,1,1,2,6,1,1,3,3,2,2,3,3,3,4,2,2,3,3,4,4,3,3,2,3,5,1,2,1,3,2,3,2,2,4,2,2,4,1,1,2,2,3,2,2,4,3,3,3,2,5,4,4,2,3,4,4,4,3,5,3,2,2,3,3,3,3,4,4,3,4,1,1,1,2,1,1,2,1,2,2,1,1,2,1,2,2,2,2,1,2,1,2,3,3,2,3,2,2,4,4,3,4,5,3
354,1,4,1,2,0,0,1,2,4,2,1,2,1,3,6,1,1,5,4,3,4,2,5,1,3,2,2,5,3,4,3,1,2,3,2,2,1,4,1,3,1,1,3,3,1,1,2,2,1,4,1,1,1,1,1,1,3,1,3,3,2,1,1,1,3,3,2,2,1,4,1,1,1,1,2,3,2,3,3,3,4,4,3,2,2,1,1,1,1,1,1,2,2,1,1,1,2,2,1,1,1,1,2,4,2,2,4,3,3,4,3,2,5,4,4
355,1,4,1,1,1,2,1,2,3,3,2,2,1,1,6,2,2,2,2,2,3,3,5,4,3,4,2,4,2,3,4,1,2,3,4,2,1,1,2,3,1,1,3,4,3,2,2,3,1,1,1,1,1,1,3,3,3,2,3,3,4,4,3,1,3,3,4,4,1,5,3,4,1,2,3,3,2,3,3,3,2,4,3,3,2,1,1,1,2,1,1,2,2,2,1,1,2,2,2,1,1,1,3,4,4,3,4,4,3,4,3,2,4,5,3
356,2,2,1,1,1,2,1,2,4,4,1,4,1,3,6,1,1,4,4,3,2,1,1,1,1,1,1,1,1,3,1,2,2,5,2,3,2,1,2,4,1,2,2,3,3,2,1,2,2,2,3,2,2,3,2,2,3,3,3,4,5,4,3,2,2,2,3,2,3,5,4,1,2,3,2,4,4,3,4,2,3,3,4,5,5,1,1,2,1,1,1,1,1,1,1,1,1,1,1,1,2,1,1,1,1,1,1,1,1,3,4,1,5,5,3
357,1,1,2,1,2,0,2,1,3,3,2,4,1,2,6,2,2,5,5,2,3,2,3,3,2,2,3,1,3,3,2,3,3,3,3,4,2,3,3,3,4,4,3,2,3,1,3,5,2,3,3,3,3,2,3,3,4,2,2,3,3,3,3,3,3,3,4,2,3,4,4,2,3,4,4,3,1,3,4,2,3,4,3,2,2,2,2,2,2,2,2,2,2,2,2,2,2,2,2,2,1,1,4,2,3,2,4,4,3,2,3,2,5,5,2
358,1,3,1,1,1,3,1,2,3,4,2,1,2,2,6,1,1,2,1,1,2,2,3,2,3,2,3,1,2,3,3,1,1,2,3,2,2,2,2,2,2,3,3,2,2,2,2,2,1,2,2,1,3,2,2,4,3,3,2,2,2,5,5,1,1,1,1,1,1,2,2,2,2,3,4,2,2,1,3,4,3,3,4,4,4,2,1,2,1,2,1,1,1,1,1,1,1,2,2,1,1,1,2,1,2,3,5,4,2,3,4,2,5,4,4
359,1,4,1,2,0,0,1,2,3,2,2,4,1,3,6,1,1,2,2,3,2,4,3,3,2,3,4,4,1,3,2,4,2,3,3,3,2,2,2,4,3,1,4,1,3,1,2,3,1,1,1,2,1,1,1,3,3,4,4,3,4,3,4,2,2,5,5,4,1,4,3,1,5,3,1,1,1,3,3,1,5,3,3,2,2,1,1,2,1,1,2,1,1,1,1,1,1,1,2,2,2,2,2,4,3,3,2,1,3,4,3,1,5,5,3
360,2,2,1,2,0,0,1,2,4,2,2,3,1,1,6,1,1,1,1,1,1,1,4,2,4,3,3,3,3,3,3,2,2,1,3,2,2,2,3,4,3,3,2,2,2,1,4,3,2,3,3,3,4,4,5,5,4,3,5,2,2,2,2,1,1,1,1,1,1,1,1,1,1,1,3,2,3,3,4,3,5,3,3,2,2,2,1,1,1,1,1,1,1,1,1,1,1,1,1,1,1,1,1,1,1,1,3,4,2,2,3,2,4,4,2
361,1,3,1,1,1,2,2,2,1,1,3,2,2,2,6,1,1,2,2,1,1,1,3,5,4,4,2,4,2,4,3,3,3,4,4,3,2,5,4,5,3,3,3,2,3,2,2,5,2,4,1,4,4,1,2,2,5,4,4,3,4,4,3,1,5,3,2,5,4,5,4,3,5,4,4,4,4,5,4,4,4,1,1,2,1,2,2,2,1,2,2,1,1,2,1,1,2,2,2,2,1,1,3,3,3,2,4,4,4,4,4,3,3,3,1
362,1,4,3,1,1,2,1,1,3,4,1,4,1,1,6,2,2,2,2,3,1,3,1,1,2,3,2,3,2,3,4,5,2,2,4,2,1,4,1,2,1,2,1,1,3,1,1,2,1,1,1,1,3,4,2,4,5,5,2,5,2,3,5,1,3,2,4,5,2,4,3,3,5,5,4,5,5,5,5,4,5,5,3,5,5,2,1,2,1,2,2,1,1,2,1,1,2,2,1,1,1,1,4,2,4,4,2,3,2,2,4,2,4,4,2
363,1,1,1,1,1,3,2,2,3,3,2,3,1,2,7,1,1,4,4,2,3,2,2,2,5,2,5,5,3,5,5,3,5,4,5,5,2,3,1,3,5,4,5,5,5,4,2,5,1,5,2,3,2,3,4,1,5,4,3,2,4,3,2,1,3,5,5,5,5,5,3,2,5,5,5,5,3,5,5,5,4,5,2,3,1,2,2,2,1,1,2,2,1,2,1,1,2,2,2,2,1,1,5,3,3,5,4,3,3,5,2,3,5,4,3
364,1,4,1,2,0,0,1,1,4,2,1,4,1,3,7,1,1,3,2,1,3,4,1,1,1,1,1,1,2,1,4,3,2,2,2,2,2,3,1,3,2,3,2,5,5,2,1,2,1,1,1,2,2,2,1,2,1,2,1,1,3,3,3,1,1,2,2,2,4,3,1,1,3,4,3,5,2,2,1,2,5,5,1,5,5,2,2,2,2,2,2,1,2,2,1,1,1,2,2,1,1,1,3,2,2,2,4,4,3,4,3,3,2,2,2
365,1,2,3,1,2,0,1,1,4,3,2,1,1,2,7,2,2,3,2,2,1,5,2,1,1,1,2,2,2,5,2,5,2,5,1,5,1,5,3,2,3,3,3,3,5,1,1,1,3,1,1,1,1,1,1,4,4,4,5,3,2,2,2,1,1,3,3,5,5,3,4,4,5,4,4,4,3,5,5,3,4,5,1,5,5,2,2,2,1,2,2,2,2,2,1,1,2,2,2,1,2,1,2,1,2,5,4,4,3,3,4,2,4,5,2
366,2,1,1,1,1,2,2,1,4,3,2,3,1,2,7,1,1,5,1,4,5,5,5,3,4,4,5,2,5,5,5,3,3,5,2,5,4,4,5,4,2,3,3,3,5,2,5,1,5,5,5,3,3,1,5,4,5,5,5,5,5,2,3,3,5,4,4,2,4,4,5,5,2,2,5,5,2,5,5,5,5,5,5,1,3,2,2,2,2,1,1,1,1,2,1,1,1,2,2,1,2,1,5,2,3,1,5,5,1,3,3,4,5,5,2
367,1,3,1,1,1,2,1,2,4,3,1,4,1,4,7,2,2,3,5,2,5,2,5,1,3,1,2,3,4,5,5,5,4,3,2,5,5,3,2,1,4,3,1,1,4,1,4,5,3,1,2,4,3,1,1,3,5,5,4,3,5,5,5,1,3,5,5,5,5,4,3,3,2,4,5,2,1,3,3,2,5,3,3,5,5,1,2,2,1,1,2,1,1,1,2,1,2,2,1,1,1,1,3,2,3,3,4,3,2,2,4,2,5,5,3
368,1,2,3,1,1,2,1,1,3,4,2,2,1,2,7,1,1,2,2,2,2,3,4,1,2,2,5,2,1,3,3,2,1,2,3,2,2,4,4,4,2,2,2,2,2,2,3,3,2,2,2,2,2,2,2,3,2,2,3,3,3,3,3,3,3,3,3,3,3,2,3,3,3,3,3,3,3,3,3,3,3,3,2,3,3,1,1,2,1,1,1,1,2,1,1,1,1,1,1,1,1,1,3,2,2,2,2,2,2,1,3,2,1,1,3
369,1,4,1,2,0,0,2,2,3,1,3,3,2,4,7,1,1,4,5,2,5,4,4,2,3,4,1,3,5,5,4,4,3,2,4,2,2,5,4,3,3,5,2,2,2,2,3,4,2,4,1,3,3,2,1,4,2,1,4,1,3,3,3,3,3,3,4,5,1,5,3,5,5,3,3,5,1,3,3,2,5,5,5,1,1,1,2,2,2,1,2,2,1,2,1,1,2,2,2,1,2,1,5,4,5,4,4,3,3,3,5,3,4,3,5
370,2,2,1,1,1,2,2,1,2,3,2,1,1,2,7,2,2,5,4,2,2,1,1,1,5,2,3,5,3,1,4,1,4,2,4,2,3,3,5,3,2,2,4,2,5,3,4,3,2,3,2,2,2,2,3,2,4,4,4,3,4,4,4,2,4,3,4,3,3,4,4,4,3,4,4,4,3,4,4,4,4,3,2,2,2,2,2,2,2,1,2,2,1,2,2,1,2,2,1,1,1,1,2,3,3,4,4,4,2,2,3,2,5,5,2
371,1,1,1,1,1,2,2,2,4,3,1,4,1,4,7,1,1,3,3,2,3,2,4,2,4,4,3,1,3,2,4,4,3,3,2,3,2,2,1,2,3,3,3,3,4,2,2,2,2,3,2,4,3,2,3,2,3,4,4,2,4,4,4,2,3,4,4,4,4,3,2,4,4,3,5,3,2,4,4,3,4,2,2,2,2,2,1,2,1,1,2,1,1,2,1,1,2,2,2,2,2,1,4,4,4,4,3,4,2,4,3,3,3,4,2
372,1,3,3,1,1,2,1,1,3,4,2,1,1,1,7,2,2,3,3,3,2,1,1,3,2,2,3,3,3,3,4,3,1,3,3,3,2,2,2,3,3,2,3,1,3,2,2,2,4,1,1,1,1,1,2,2,2,2,3,2,2,3,3,4,2,1,1,3,2,2,3,3,3,3,3,3,4,4,2,2,2,3,4,3,3,2,1,1,1,2,2,2,2,2,1,1,2,2,2,2,1,2,2,1,2,3,4,4,2,3,3,1,4,5,3
373,1,2,1,1,1,3,2,2,3,1,3,3,2,2,7,1,2,5,5,5,5,3,3,2,3,3,4,5,4,2,4,3,3,3,5,4,2,5,3,2,5,4,4,3,5,5,3,3,3,3,2,2,2,1,3,3,3,3,3,3,3,5,3,1,1,3,1,5,5,3,3,3,5,3,3,3,3,5,3,3,5,3,4,2,2,2,2,1,1,2,2,2,2,2,1,1,2,2,2,2,1,1,2,2,3,4,4,4,4,2,4,3,5,5,3
374,1,1,1,2,0,0,2,1,3,2,2,2,1,2,7,2,2,3,2,1,3,3,3,1,3,3,5,5,5,3,1,5,5,4,2,1,3,5,1,3,1,3,3,3,3,1,2,3,1,1,1,3,4,2,2,2,4,4,3,2,4,3,3,5,4,2,4,1,5,5,1,3,5,4,5,3,3,3,4,4,4,4,3,2,1,2,1,1,1,1,2,1,2,2,1,1,1,2,1,2,1,1,4,5,2,1,5,4,5,4,2,1,5,5,2
375,2,4,3,1,1,2,2,2,4,3,1,4,1,1,7,1,1,2,2,1,4,3,5,4,5,3,1,1,2,4,2,4,4,3,5,3,1,3,1,3,1,2,3,2,5,2,3,4,1,3,3,3,3,2,5,5,3,2,3,3,2,4,3,1,3,3,4,5,4,4,3,3,3,3,4,2,3,3,3,5,1,1,1,1,3,1,1,1,1,1,2,1,1,2,1,1,2,2,2,2,1,1,3,4,4,4,4,5,2,2,4,3,4,5,4
376,1,2,1,1,1,2,1,2,3,4,2,3,1,2,7,1,1,3,3,2,3,3,4,2,3,4,4,4,3,3,3,1,2,3,3,2,2,4,2,2,2,2,2,1,3,2,3,2,3,4,4,4,4,2,2,2,4,4,4,3,1,2,4,3,4,4,4,3,2,4,2,3,3,4,4,3,2,4,3,3,4,4,2,2,1,2,2,1,1,2,2,2,1,1,2,1,2,2,2,2,1,1,4,3,5,4,4,4,5,3,4,5,5,5,4
377,1,3,1,1,2,0,2,1,1,1,3,1,2,3,7,2,2,3,3,2,3,5,5,4,3,4,2,4,4,4,3,5,3,2,2,3,5,3,1,5,3,4,4,3,4,1,2,5,2,3,1,5,4,2,3,2,2,3,4,3,3,2,2,3,3,2,2,1,4,2,3,4,2,4,4,2,2,5,5,4,5,1,4,1,2,2,1,2,1,1,2,1,2,2,1,2,1,1,1,1,2,2,2,4,4,5,4,2,2,3,4,3,3,3,3
378,2,1,1,2,0,0,2,2,4,3,2,3,1,2,7,1,1,2,3,2,5,3,4,5,2,1,2,2,2,4,2,3,2,2,1,2,2,4,1,3,1,2,3,2,2,1,2,2,1,5,3,2,5,1,2,1,4,4,2,3,3,4,3,1,1,1,2,4,3,5,3,4,1,4,3,4,1,4,4,2,3,5,2,1,4,2,2,2,1,1,1,1,1,2,1,1,1,1,1,1,1,1,1,1,1,5,5,3,3,3,2,1,5,4,4
379,1,1,2,1,2,0,2,2,4,2,2,1,1,2,7,2,2,4,4,5,5,4,3,2,2,3,1,4,4,2,5,3,5,3,2,3,3,1,1,3,3,3,4,3,5,1,2,4,3,4,3,5,4,2,3,3,3,5,2,2,4,4,4,2,2,4,4,3,4,5,5,3,3,4,5,3,2,4,4,2,5,3,2,2,2,2,2,2,2,2,2,1,1,1,1,1,2,1,1,2,1,1,2,3,3,2,4,3,3,3,2,3,4,4,2
380,1,4,1,1,1,2,1,1,4,3,1,4,1,1,7,1,1,3,4,3,2,2,3,1,3,5,2,3,4,2,2,2,3,2,2,1,2,2,2,2,2,4,2,4,5,2,3,4,2,3,2,4,3,2,1,3,3,4,3,3,4,3,3,3,4,3,2,3,4,4,5,4,4,2,5,3,4,5,5,2,4,1,1,2,3,2,1,2,1,2,2,1,1,2,1,1,1,2,1,1,1,1,4,2,4,2,4,3,2,1,3,4,4,3,2
381,1,2,1,1,1,2,2,2,2,1,3,2,2,2,7,2,2,1,3,2,1,2,1,1,2,3,1,2,3,2,3,1,3,2,5,2,2,1,4,5,2,3,2,4,3,1,3,2,2,1,2,1,3,2,3,4,3,4,4,5,5,3,2,2,1,3,5,1,2,3,2,3,1,3,4,5,2,3,2,1,4,3,2,2,3,2,2,2,1,1,2,1,2,2,1,1,1,1,2,2,1,1,4,4,2,2,4,3,1,3,1,4,4,5,2
382,1,3,1,2,0,0,1,2,3,2,2,1,1,2,7,1,2,3,3,2,2,3,3,3,2,2,3,3,3,4,3,3,3,2,3,2,1,2,1,3,4,3,3,3,3,2,2,4,1,1,2,2,2,5,2,4,3,3,3,2,5,4,4,2,3,4,5,4,3,5,3,2,2,3,3,3,4,4,5,2,4,1,1,1,1,2,2,2,1,2,2,1,1,2,1,2,2,2,2,2,2,1,3,3,2,2,3,2,2,4,4,3,4,4,3
383,1,1,2,1,1,2,1,1,1,1,3,3,2,1,7,1,1,3,3,2,2,3,3,3,4,2,2,3,3,4,4,3,3,2,3,5,1,2,1,3,2,3,2,2,4,2,2,4,1,1,2,2,3,2,2,4,3,3,3,2,5,4,4,2,3,4,4,4,3,5,3,2,2,3,3,3,3,4,4,3,4,1,1,1,2,1,1,2,1,2,2,1,1,2,1,2,2,2,2,1,2,1,2,3,3,2,3,2,2,4,4,3,4,5,3
384,2,3,1,1,1,2,2,2,3,3,2,2,1,3,7,1,1,5,4,3,4,2,5,1,3,2,2,5,3,4,3,1,2,3,2,2,1,4,1,3,1,1,3,3,1,1,2,2,1,4,1,1,1,1,1,1,3,1,3,3,2,1,1,1,3,3,2,2,1,4,1,1,1,1,2,3,2,3,3,3,4,4,3,2,2,1,1,1,1,1,1,2,2,1,1,1,2,2,1,1,1,1,2,4,2,3,4,3,3,4,3,2,5,4,4
385,1,2,1,1,1,3,2,1,4,3,1,4,1,2,7,1,1,2,2,2,3,3,5,4,3,4,2,4,2,3,4,1,2,3,4,2,1,1,2,3,1,1,3,3,3,2,2,3,1,1,1,1,1,1,3,3,3,2,3,3,4,4,3,1,3,3,4,4,1,5,3,4,1,2,3,3,2,3,3,3,2,4,3,3,2,1,1,1,2,1,1,2,2,2,1,1,2,2,2,1,1,1,3,4,4,3,4,4,2,4,3,2,4,5,3
386,1,3,1,2,0,0,1,1,3,2,2,3,1,3,7,1,1,4,4,3,2,1,1,1,1,1,1,1,1,3,1,2,2,5,2,3,2,1,2,4,1,2,2,3,3,2,1,2,2,2,3,2,2,3,2,2,3,3,3,4,5,4,3,2,2,2,3,2,3,5,4,1,2,3,2,4,4,3,4,2,3,3,4,5,5,1,1,2,1,1,1,1,1,1,1,1,1,1,1,1,2,1,1,1,1,1,1,1,1,3,4,1,5,5,3
387,1,2,3,2,0,0,2,2,1,1,3,1,2,1,7,2,2,5,5,2,3,2,3,3,2,2,3,3,3,3,2,3,3,3,3,4,2,3,3,3,4,4,3,2,3,1,3,5,2,3,3,3,3,2,3,3,4,2,2,3,3,3,3,3,3,3,4,2,3,4,4,2,3,4,4,3,1,3,4,2,3,4,3,2,2,2,2,2,2,2,2,2,2,2,2,2,2,2,2,2,1,1,4,2,3,2,4,4,3,2,3,2,5,5,2
388,1,1,1,1,1,2,2,1,3,3,2,2,1,2,7,1,2,2,1,1,2,2,3,2,3,2,3,4,2,3,3,1,1,2,3,2,2,2,2,2,2,3,3,2,2,2,2,2,1,2,2,1,3,2,2,4,3,3,2,2,2,5,5,1,1,1,1,1,1,2,2,2,2,3,4,2,2,1,3,4,3,3,4,4,4,2,1,2,1,2,1,1,1,1,1,1,1,2,2,1,1,1,2,1,2,2,5,4,2,3,4,2,5,4,4
389,1,4,1,1,1,2,2,2,3,3,2,3,1,3,7,2,2,2,2,3,2,4,3,3,2,3,4,4,1,3,2,4,2,3,3,3,2,2,2,4,3,1,4,1,3,1,2,3,1,1,1,2,1,1,1,3,3,4,4,3,4,3,4,2,2,5,5,4,1,4,3,1,5,3,1,1,1,3,3,1,5,3,3,2,2,1,1,2,1,1,2,1,1,1,1,1,1,1,2,2,2,2,2,4,3,3,2,1,3,4,3,1,5,5,3
390,1,2,1,1,1,3,1,2,4,3,2,1,1,2,7,1,2,1,1,1,1,1,4,2,4,3,3,3,3,3,3,2,2,1,3,2,2,2,3,4,3,3,2,2,2,1,4,3,2,3,3,3,4,4,5,5,4,3,5,2,2,2,2,1,1,1,1,1,1,1,1,1,1,1,3,2,3,3,4,3,5,3,3,2,2,2,1,1,1,1,1,1,1,1,1,1,1,1,1,1,1,1,1,1,1,1,3,4,2,2,3,2,4,4,2
391,1,4,2,1,1,2,2,2,4,3,1,4,1,2,7,2,2,2,2,1,1,1,3,5,4,4,2,1,2,4,3,3,3,4,4,3,2,5,4,5,3,3,3,2,3,2,2,5,2,4,1,4,4,1,2,2,5,4,4,3,4,4,3,1,5,3,2,5,4,5,4,3,5,4,4,4,4,5,4,4,4,1,1,2,1,2,2,2,1,2,2,1,1,2,1,1,2,2,2,2,1,1,3,3,3,3,4,4,4,4,4,3,3,3,1
392,1,1,1,2,0,0,1,2,3,2,2,3,1,1,7,1,1,2,2,3,1,3,1,1,2,3,2,3,2,3,4,5,2,2,4,2,1,4,1,2,1,2,1,1,3,1,1,2,1,1,1,1,3,4,2,4,5,5,2,5,2,3,5,1,3,2,4,5,2,4,3,3,5,5,4,5,5,5,5,4,5,5,3,5,5,2,1,2,1,2,2,1,1,2,1,1,2,2,1,1,1,1,4,2,4,4,2,3,2,2,4,2,4,4,2
393,1,4,1,1,1,2,2,1,3,3,2,2,3,3,7,1,1,4,4,2,3,2,2,2,5,2,5,5,3,5,5,3,5,4,5,5,2,3,1,3,5,4,5,3,5,4,2,5,1,5,2,3,2,3,4,1,5,4,3,2,4,3,2,1,3,5,5,5,5,5,3,2,5,5,5,5,3,5,5,5,4,5,2,3,1,2,2,2,1,1,2,2,1,2,1,1,2,2,2,2,1,1,5,3,3,5,4,3,3,5,2,3,5,4,3
394,1,2,1,2,0,0,1,2,3,2,2,1,1,2,7,2,2,3,2,1,3,4,1,1,1,1,1,1,2,1,4,3,2,2,2,2,2,3,1,3,2,3,2,5,5,2,1,2,1,1,1,2,2,2,1,2,1,2,1,1,3,3,3,1,1,2,2,2,4,3,1,1,3,4,3,5,2,2,1,2,5,5,1,5,5,2,2,2,2,2,2,1,2,2,1,1,1,2,2,1,1,1,3,2,2,2,4,4,2,4,3,3,2,2,2
395,2,4,2,1,1,2,1,2,1,1,3,3,2,4,7,1,1,3,2,2,1,5,2,1,1,1,2,2,2,5,2,5,2,5,1,5,1,5,3,2,3,3,3,3,5,1,1,1,3,1,1,1,1,1,1,4,4,4,5,3,2,2,2,1,1,3,3,5,5,3,4,4,5,4,4,4,3,5,5,3,4,5,1,5,5,2,2,2,1,2,2,2,2,2,1,1,2,2,2,1,2,1,3,1,3,5,4,4,2,3,4,2,4,5,2
396,2,2,1,1,1,2,2,1,4,3,2,1,1,2,7,1,1,5,1,4,5,5,5,3,4,4,5,2,5,5,5,3,3,5,2,5,4,4,5,4,2,3,3,3,5,5,5,1,5,5,5,3,3,1,5,4,5,5,5,5,5,2,3,3,5,4,4,2,4,4,5,5,2,2,5,5,2,5,5,5,5,5,5,1,3,2,2,2,2,1,1,1,1,2,1,1,1,2,2,1,2,1,5,2,3,1,5,5,1,3,3,4,5,5,2
397,1,4,1,1,2,3,1,2,4,4,2,3,1,1,7,1,1,3,5,2,5,2,5,1,3,1,2,3,4,5,5,5,4,3,2,5,5,3,2,1,4,3,1,1,4,1,4,5,3,1,2,4,3,1,1,3,5,5,4,3,5,5,5,1,3,5,5,5,5,4,3,3,2,4,5,2,1,3,3,2,5,3,3,5,5,1,2,2,1,1,2,1,1,1,2,1,2,2,1,1,1,1,2,2,3,3,4,3,2,2,4,2,5,5,3
398,2,3,1,1,1,2,2,2,2,1,3,2,2,3,7,1,1,2,2,2,2,3,4,1,2,2,5,2,1,3,3,2,3,2,3,2,2,4,4,4,2,2,2,2,2,2,3,3,2,2,2,2,2,2,2,3,2,2,3,3,3,3,3,3,3,3,3,3,3,2,3,3,3,3,3,3,3,3,3,3,3,3,2,3,3,1,1,2,1,1,1,1,2,1,1,1,1,1,1,1,1,1,2,2,2,3,2,2,3,1,3,2,1,1,3
399,2,3,1,1,1,2,2,2,4,3,1,4,1,2,7,1,2,4,5,2,5,4,4,2,3,4,1,1,5,5,4,4,3,2,4,2,2,5,4,3,3,5,2,2,2,2,3,4,2,4,1,3,3,2,1,4,2,1,4,1,3,3,3,3,3,3,4,5,1,5,3,5,5,3,3,5,1,3,3,2,5,5,5,1,1,1,2,2,2,1,2,2,1,2,1,1,2,2,2,1,2,1,5,4,5,4,4,3,3,3,5,3,4,3,5
400,1,4,2,1,1,2,2,1,3,4,2,2,1,1,7,2,2,5,4,2,2,1,1,1,5,2,3,5,3,1,4,1,4,2,4,2,3,3,5,3,2,2,4,2,5,3,4,3,2,3,2,2,2,2,3,2,4,4,4,3,4,4,4,2,4,3,4,3,3,4,4,4,3,4,4,4,3,4,4,4,4,3,2,2,2,2,2,2,2,1,2,2,1,2,2,1,2,2,1,1,1,1,2,2,3,4,4,4,3,4,3,2,5,5,2
401,2,1,1,1,1,2,2,2,4,3,1,4,1,4,7,1,1,3,3,2,3,2,4,2,4,4,3,3,3,2,4,4,3,3,2,3,2,2,1,2,3,3,3,3,4,2,2,2,2,3,2,4,3,2,3,2,3,4,4,2,4,4,4,2,3,4,4,4,4,3,2,4,4,3,5,3,2,4,4,3,4,2,2,2,2,2,1,2,1,1,2,1,1,2,1,1,2,2,2,2,2,1,4,4,4,4,3,4,3,4,3,3,3,4,2
402,1,4,1,2,0,0,1,2,3,2,2,2,1,2,7,1,1,3,3,3,2,1,1,3,2,2,3,3,3,3,4,3,3,3,3,3,2,2,2,3,3,2,3,1,3,5,2,2,4,1,1,1,1,1,2,2,2,2,3,2,2,3,3,4,2,1,1,3,2,2,3,3,3,3,3,3,4,4,2,2,2,3,4,3,3,2,1,1,1,2,2,2,2,2,1,1,2,2,2,2,1,2,2,1,2,2,4,4,3,3,3,1,4,5,3
403,2,2,1,1,1,3,2,2,4,3,1,4,1,4,7,1,2,5,5,5,5,3,3,2,3,3,4,5,4,2,4,3,3,3,5,4,2,5,3,2,5,4,4,4,5,5,3,3,3,3,2,2,2,1,3,3,3,3,3,3,3,5,3,1,1,3,1,5,5,3,3,3,5,3,3,3,3,5,3,3,5,3,4,2,2,2,2,1,1,2,2,2,2,2,1,1,2,2,2,2,1,1,2,3,2,4,4,4,4,2,4,3,5,5,3
404,1,4,2,1,1,2,2,1,3,3,2,3,1,1,7,2,2,3,2,1,3,3,3,1,3,3,5,5,5,3,1,5,5,4,2,1,3,5,1,3,1,3,3,3,3,1,2,3,1,1,1,3,4,2,2,2,4,4,3,2,4,3,3,5,4,2,4,1,5,5,1,3,5,4,5,3,3,3,4,4,4,4,3,2,1,2,1,1,1,1,2,1,2,2,1,1,1,2,1,2,1,1,4,5,2,1,5,4,5,4,2,1,5,5,2
405,1,2,1,2,0,0,2,2,3,2,2,1,1,3,8,1,1,2,2,1,4,3,5,4,5,3,1,4,2,4,2,4,4,3,5,3,1,3,1,3,1,2,3,2,5,2,3,4,1,3,3,3,3,2,5,5,3,2,3,3,2,4,3,1,3,3,4,5,4,4,3,3,3,3,4,2,3,3,3,5,1,1,1,1,3,1,1,1,1,1,2,1,1,2,1,1,2,2,2,2,1,1,3,4,4,4,4,5,2,4,4,3,4,5,4
406,1,2,1,1,1,2,1,2,1,1,3,2,2,2,8,2,2,3,3,2,3,3,4,2,3,4,4,4,3,3,3,1,2,3,3,2,2,4,2,2,2,2,2,1,3,2,3,2,3,4,4,4,4,2,2,2,4,4,4,3,1,2,4,3,4,4,4,3,2,4,2,3,3,4,4,3,2,4,3,3,4,4,2,2,1,2,2,1,1,2,2,2,1,1,2,1,2,2,2,2,1,1,4,3,5,4,4,4,5,3,4,5,5,5,4
407,1,2,1,1,1,2,1,1,3,3,2,3,1,1,8,1,1,3,3,2,3,5,5,4,3,4,2,4,4,4,3,5,1,2,2,3,5,3,1,5,3,4,4,3,4,1,2,5,2,3,1,5,4,2,3,2,2,3,4,3,3,2,2,3,3,2,2,1,4,2,3,4,2,4,4,2,2,5,5,4,5,1,4,1,2,2,1,2,1,1,2,1,2,2,1,2,1,1,1,1,2,2,3,4,4,5,4,2,2,3,4,3,3,3,3
408,1,3,2,1,1,2,2,2,4,3,1,1,1,4,8,1,1,2,3,2,5,3,4,5,2,1,2,2,2,4,2,3,2,2,1,2,2,4,1,3,1,2,3,2,2,1,2,2,1,5,3,2,5,1,2,1,4,4,2,3,3,4,3,1,1,1,2,4,3,5,3,4,1,4,3,4,1,4,4,2,3,5,2,1,4,2,2,2,1,1,1,1,1,2,1,1,1,1,1,1,1,1,1,1,1,5,5,3,3,3,2,1,5,4,4
409,2,4,1,1,1,2,1,2,3,3,2,3,1,2,8,1,1,4,4,5,5,4,3,2,2,3,1,4,4,2,5,3,5,3,2,3,3,1,1,3,3,3,4,3,5,1,2,4,3,4,3,5,4,2,3,3,3,5,2,2,4,4,4,2,2,4,4,3,4,5,5,3,3,4,5,3,2,4,4,2,5,3,2,2,2,2,2,2,2,2,2,1,1,1,1,1,2,1,1,2,1,1,3,3,3,2,4,3,3,3,2,3,4,4,2
410,1,2,1,1,1,3,1,1,2,1,3,2,2,2,8,2,2,3,4,3,2,2,3,1,3,5,2,1,4,2,2,2,3,2,2,1,2,2,2,2,2,4,2,4,5,2,3,4,2,3,2,4,3,2,1,3,3,4,3,3,4,3,3,3,4,3,2,3,4,4,5,4,4,2,5,3,4,5,5,2,4,1,1,2,3,2,1,2,1,2,2,1,1,2,1,1,1,2,1,1,1,1,4,2,4,2,4,3,2,1,3,4,4,3,2
411,1,2,1,2,0,0,2,2,3,2,2,3,1,2,8,1,1,1,3,2,1,2,1,1,2,3,1,2,3,2,3,4,3,2,5,2,2,1,4,5,2,3,2,3,3,1,3,2,2,1,2,1,3,2,3,4,3,4,4,5,5,3,2,2,1,3,5,1,2,3,2,3,1,3,4,5,2,3,2,1,4,3,2,2,3,2,2,2,1,1,2,1,2,2,1,1,1,1,2,2,1,1,4,4,3,2,4,3,1,3,1,4,4,5,2
412,1,1,1,1,2,0,1,2,4,2,1,4,1,2,8,1,1,3,3,2,2,3,3,3,2,2,3,3,3,4,3,3,3,2,3,2,1,2,1,3,2,3,3,3,3,2,2,4,1,1,2,2,2,5,2,4,3,3,3,2,5,4,4,2,3,4,5,4,3,5,3,2,2,3,3,3,4,4,5,2,4,1,1,1,1,2,2,2,1,2,2,1,1,2,1,2,2,2,2,2,2,1,3,3,3,2,3,2,2,4,4,3,4,4,3
413,1,3,1,1,1,2,2,1,1,1,3,2,2,2,8,1,2,3,3,2,2,3,3,3,4,2,2,3,3,4,4,3,3,2,3,5,1,2,1,3,2,3,2,2,4,5,2,4,1,1,2,2,3,2,2,4,3,3,3,2,5,4,4,2,3,4,4,4,3,5,3,2,2,3,3,3,3,4,4,3,4,1,1,1,2,1,1,2,1,2,2,1,1,2,1,2,2,2,2,1,2,1,2,2,2,2,3,2,2,4,4,3,4,5,3
414,2,2,2,1,1,2,1,2,4,4,2,3,1,3,8,1,1,5,4,3,4,2,5,1,3,2,2,5,3,4,3,1,2,3,2,2,1,4,1,3,1,1,3,3,1,1,2,2,1,4,1,1,1,1,1,1,3,1,3,3,2,1,1,1,3,3,2,2,1,4,1,1,1,1,2,3,2,3,3,3,4,4,3,2,2,1,1,1,1,1,1,2,2,1,1,1,2,2,1,1,1,1,2,4,3,3,4,3,3,4,3,2,5,4,4
415,1,2,1,1,1,2,1,2,2,1,3,1,2,2,8,1,1,2,2,2,3,3,5,4,3,4,2,4,2,3,4,1,2,3,4,2,1,1,2,3,1,1,3,3,3,2,2,3,1,1,1,1,1,1,3,3,3,2,3,3,4,4,3,1,3,3,4,4,1,5,3,4,1,2,3,3,2,3,3,3,2,4,3,3,2,1,1,1,2,1,1,2,2,2,1,1,2,2,2,1,1,1,3,4,4,3,4,4,3,4,3,2,4,5,3
416,1,3,1,2,0,0,2,2,3,2,2,3,1,1,8,1,1,4,4,3,2,1,1,1,1,1,1,1,1,3,1,2,2,5,2,3,2,1,2,4,1,2,2,3,3,2,1,2,2,2,3,2,2,3,2,2,3,3,3,4,5,4,3,2,2,2,3,2,3,5,4,1,2,3,2,4,4,3,4,2,3,3,4,5,5,1,1,2,1,1,1,1,1,1,1,1,1,1,1,1,2,1,1,1,1,1,1,1,1,3,4,1,5,5,3
417,1,3,1,1,2,0,1,1,4,2,1,3,1,4,8,1,2,5,5,2,3,2,3,3,2,2,3,1,3,3,2,3,3,3,3,4,2,3,3,3,4,4,3,2,3,1,3,5,2,3,3,3,3,2,3,3,4,2,2,3,3,3,3,3,3,3,4,2,3,4,4,2,3,4,4,3,1,3,4,2,3,4,3,2,2,2,2,2,2,2,2,2,2,2,2,2,2,2,2,2,1,1,4,3,2,2,4,4,3,2,3,2,5,5,2
418,1,2,2,1,1,1,1,2,3,2,2,3,1,2,8,1,1,2,1,1,2,2,3,2,3,2,3,4,2,3,3,1,1,2,3,2,2,2,2,2,2,3,3,2,2,2,2,2,1,2,2,1,3,2,2,4,3,3,2,2,2,5,5,1,1,1,1,1,1,2,2,2,2,3,4,2,2,1,3,4,3,3,4,4,4,2,1,2,1,2,1,1,1,1,1,1,1,2,2,1,1,1,2,1,2,2,5,4,2,3,4,2,5,4,4
419,2,2,1,1,1,2,2,2,3,3,2,2,1,1,8,2,2,2,2,3,2,4,3,3,2,3,4,4,1,3,2,4,2,3,3,3,2,2,2,4,3,1,4,1,3,1,2,3,1,1,1,2,1,1,1,3,3,4,4,3,4,3,4,2,2,5,5,4,1,4,3,1,5,3,1,1,1,3,3,1,5,3,3,2,2,1,1,2,1,1,2,1,1,1,1,1,1,1,2,2,2,2,2,4,2,3,2,1,3,4,3,1,5,5,3
420,1,3,1,1,1,2,2,2,4,2,1,4,1,3,8,1,1,1,1,1,1,1,4,2,4,3,3,3,3,3,3,2,2,1,3,2,2,2,3,4,3,3,2,2,2,1,4,3,2,3,3,3,4,4,5,5,4,3,5,2,2,2,2,1,1,1,1,1,1,1,1,1,1,1,3,2,3,3,4,3,5,3,3,2,2,2,1,1,1,1,1,1,1,1,1,1,1,1,1,1,1,1,1,1,1,1,3,4,2,2,3,2,4,4,2
421,1,1,1,1,1,2,2,1,3,4,2,3,1,2,8,1,1,2,2,1,1,1,3,5,4,4,2,4,2,4,3,3,3,4,4,3,2,5,4,5,3,3,3,2,3,2,2,5,2,4,1,4,4,1,2,2,5,4,4,3,4,4,3,1,5,3,2,5,4,5,4,3,5,4,4,4,4,5,4,4,4,1,1,2,1,2,2,2,1,2,2,1,1,2,1,1,2,2,2,2,1,1,3,3,3,3,4,4,4,4,4,3,3,3,1
422,1,4,2,2,0,0,2,2,3,2,2,2,1,2,8,1,2,2,2,3,1,3,1,1,2,3,2,3,2,3,4,5,2,2,4,2,1,4,1,2,1,2,1,1,3,1,1,2,1,1,1,1,3,4,2,4,5,5,2,5,2,3,5,1,3,2,4,5,2,4,3,3,5,5,4,5,5,5,5,4,5,5,3,5,5,2,1,2,1,2,2,1,1,2,1,1,2,2,1,1,1,1,4,2,4,4,2,3,2,2,4,2,4,4,2
423,1,2,1,1,2,0,1,1,4,2,1,4,2,4,8,1,1,4,4,2,3,2,2,2,5,2,5,5,3,5,5,3,5,4,5,5,2,3,1,3,5,4,5,4,5,4,2,5,1,5,2,3,2,3,4,1,5,4,3,2,4,3,2,1,3,5,5,5,5,5,3,2,5,5,5,5,3,5,5,5,4,5,2,3,1,2,2,2,1,1,2,2,1,2,1,1,2,2,2,2,1,1,5,3,3,5,4,3,2,5,2,3,5,4,3
424,2,2,1,2,0,0,1,2,3,2,2,3,1,2,8,2,2,3,2,1,3,4,1,1,1,1,1,1,2,1,4,3,2,2,2,2,2,3,1,3,2,3,2,5,5,2,1,2,1,1,1,2,2,2,1,2,1,2,1,1,3,3,3,1,1,2,2,2,4,3,1,1,3,4,3,5,2,2,1,2,5,5,1,5,5,2,2,2,2,2,2,1,2,2,1,1,1,2,2,1,1,1,3,2,2,2,4,4,3,4,3,3,2,2,2
425,1,4,2,1,2,0,2,2,3,2,2,1,1,4,8,1,1,3,2,2,1,5,2,1,1,1,2,2,2,5,2,5,2,5,1,5,1,5,3,2,3,3,3,3,5,1,1,1,3,1,1,1,1,1,1,4,4,4,5,3,2,2,2,1,1,3,3,5,5,3,4,4,5,4,4,4,3,5,5,3,4,5,1,5,5,2,2,2,1,2,2,2,2,2,1,1,2,2,2,1,2,1,3,1,2,5,4,4,3,3,4,2,4,5,2
426,1,2,1,1,1,2,1,1,1,1,3,2,2,2,8,1,1,5,1,4,5,5,5,3,4,4,5,2,5,5,5,3,3,5,2,5,4,4,5,4,2,3,3,3,5,2,5,1,5,5,5,3,3,1,5,4,5,5,5,5,5,2,3,3,5,4,4,2,4,4,5,5,2,2,5,5,2,5,5,5,5,5,5,1,3,2,2,2,2,1,1,1,1,2,1,1,1,2,2,1,2,1,5,2,2,1,5,5,1,3,3,4,5,5,2
427,1,3,1,2,0,0,2,2,3,2,2,3,1,3,8,1,2,3,5,2,5,2,5,1,3,1,2,3,4,5,5,5,4,3,2,5,5,3,2,1,4,3,1,1,4,1,4,5,3,1,2,4,3,1,1,3,5,5,4,3,5,5,5,1,3,5,5,5,5,4,3,3,2,4,5,2,1,3,3,2,5,3,3,5,5,1,2,2,1,1,2,1,1,1,2,1,2,2,1,1,1,1,3,2,3,3,4,3,2,2,4,2,5,5,3
428,2,2,1,1,1,2,1,2,4,4,1,1,1,1,8,1,1,2,2,2,2,3,4,1,2,2,5,2,1,3,3,2,1,2,3,2,2,4,4,4,2,2,2,2,2,2,3,3,2,2,2,2,2,2,2,3,2,2,3,3,3,3,3,3,3,3,3,3,3,2,3,3,3,3,3,3,3,3,3,3,3,3,2,3,3,1,1,2,1,1,1,1,2,1,1,1,1,1,1,1,1,1,3,2,2,3,2,2,3,1,3,2,1,1,3
429,1,2,2,1,1,2,2,2,3,2,2,3,1,2,8,1,1,4,5,2,5,4,4,2,3,4,1,1,5,5,4,4,3,2,4,2,2,5,4,3,3,5,2,2,2,2,3,4,2,4,1,3,3,2,1,4,2,1,4,1,3,3,3,3,3,3,4,5,1,5,3,5,5,3,3,5,1,3,3,2,5,5,5,1,1,1,2,2,2,1,2,2,1,2,1,1,2,2,2,1,2,1,5,4,5,4,4,3,3,3,5,3,4,3,5
430,2,4,1,1,2,0,1,1,3,2,2,2,3,2,8,2,2,5,4,2,2,1,1,1,5,2,3,5,3,1,1,1,4,2,4,2,3,3,5,3,2,2,4,2,5,3,4,3,2,3,2,2,2,2,3,2,4,4,4,3,4,4,4,2,4,3,4,3,3,4,4,4,3,4,4,4,3,4,4,4,4,3,2,2,2,2,2,2,2,1,2,2,1,2,2,1,2,2,1,1,1,1,2,3,3,4,4,4,2,4,3,2,5,5,2
431,2,2,1,1,2,0,1,2,3,2,2,3,1,3,8,1,2,3,3,2,3,2,4,2,4,4,3,3,3,2,4,4,3,3,2,3,2,2,1,2,3,3,3,3,4,2,2,2,2,3,2,4,3,2,3,2,3,4,4,2,4,4,4,2,3,4,4,4,4,3,2,4,4,3,5,3,2,4,4,3,4,2,2,2,2,2,1,2,1,1,2,1,1,2,1,1,2,2,2,2,2,1,4,4,4,4,3,4,3,4,3,3,3,4,2
432,1,1,2,1,1,2,2,2,4,3,1,4,1,2,8,1,1,3,3,3,2,1,1,3,2,2,3,3,3,3,4,3,3,3,3,3,2,2,2,3,3,2,3,1,3,2,2,2,4,1,1,1,1,1,2,2,2,2,3,2,2,3,3,4,2,1,1,3,2,2,3,3,3,3,3,3,4,4,2,2,2,3,4,3,3,2,1,1,1,2,2,2,2,2,1,1,2,2,2,2,1,2,2,1,3,3,4,4,2,3,3,1,4,5,3
433,2,3,1,2,0,0,1,2,3,2,2,1,1,1,8,2,2,5,5,5,5,3,3,2,3,3,4,5,4,2,1,3,3,3,5,4,2,5,3,2,5,4,4,3,5,5,3,3,3,3,2,2,2,1,3,3,3,3,3,3,3,5,3,1,1,3,1,5,5,3,3,3,5,3,3,3,3,5,3,3,5,3,4,2,2,2,2,1,1,2,2,2,2,2,1,1,2,2,2,2,1,1,2,3,3,4,4,4,4,2,4,3,5,5,3
434,1,2,1,1,2,0,1,2,3,2,2,2,1,4,8,1,2,3,2,1,3,3,3,1,3,3,5,5,5,3,1,1,5,4,2,1,3,5,1,3,1,3,3,3,3,1,2,3,1,1,1,3,4,2,2,2,4,4,3,2,4,3,3,5,4,2,4,1,5,5,1,3,5,4,5,3,3,3,4,4,4,4,3,2,1,2,1,1,1,1,2,1,2,2,1,1,1,2,1,2,1,1,4,5,3,1,5,4,5,4,2,1,5,5,2
435,1,2,1,1,2,0,1,2,3,2,2,3,1,2,8,1,1,2,2,1,4,3,5,4,5,3,1,4,2,4,2,1,4,3,5,3,1,3,1,3,1,2,3,2,5,2,3,4,1,3,3,3,3,2,5,5,3,2,3,3,2,4,3,1,3,3,4,5,4,4,3,3,3,3,4,2,3,3,3,5,1,1,1,1,3,1,1,1,1,1,2,1,1,2,1,1,2,2,2,2,1,1,3,4,4,4,4,5,2,4,4,3,4,5,4
436,1,3,2,1,1,2,1,1,4,3,1,1,1,3,8,1,2,3,3,2,3,3,4,2,3,4,4,4,3,3,3,1,2,3,3,2,2,4,2,2,2,2,2,1,3,2,3,2,3,4,4,4,4,2,2,2,4,4,4,3,1,2,4,3,4,4,4,3,2,4,2,3,3,4,4,3,2,4,3,3,4,4,2,2,1,2,2,1,1,2,2,2,1,1,2,1,2,2,2,2,1,1,4,3,5,4,4,4,5,3,4,5,5,5,4
437,2,4,1,1,1,2,2,2,3,3,2,2,1,2,8,1,1,3,3,2,3,5,5,4,3,4,2,4,4,4,3,5,3,2,2,3,5,3,1,5,3,4,4,3,4,1,2,5,2,3,1,5,4,2,3,2,2,3,4,3,3,2,2,3,3,2,2,1,4,2,3,4,2,4,4,2,2,5,5,4,5,1,4,1,2,2,1,2,1,1,2,1,2,2,1,2,1,1,1,1,2,2,3,4,4,5,4,2,2,3,4,3,3,3,3
438,1,2,1,2,0,0,2,2,1,1,3,3,2,3,8,2,1,2,3,2,5,3,4,5,2,1,2,2,2,4,2,3,2,2,1,2,2,4,1,3,1,2,3,2,2,1,2,2,1,5,3,2,5,1,2,1,4,4,2,3,3,4,3,1,1,1,2,4,3,5,3,4,1,4,3,4,1,4,4,2,3,5,2,1,4,2,2,2,1,1,1,1,1,2,1,1,1,1,1,1,1,1,1,1,1,5,5,3,3,3,2,1,5,4,4
439,1,2,1,1,2,0,2,1,3,2,2,1,2,2,8,1,2,4,4,5,5,4,3,2,2,3,1,4,4,2,5,3,5,3,2,3,3,1,1,3,3,3,4,3,5,1,2,4,3,4,3,5,4,2,3,3,3,5,2,2,4,4,4,2,2,4,4,3,4,5,5,3,3,4,5,3,2,4,4,2,5,3,2,2,2,2,2,2,2,2,2,1,1,1,1,1,2,1,1,2,1,1,3,2,3,2,4,3,3,3,2,3,4,4,2
440,1,2,2,1,1,2,2,2,4,3,1,4,1,3,8,1,1,3,4,3,2,2,3,1,3,5,2,3,4,2,2,2,3,2,2,1,2,2,2,2,2,4,2,4,5,2,3,4,2,3,2,4,3,2,1,3,3,4,3,3,4,3,3,3,4,3,2,3,4,4,5,4,4,2,5,3,4,5,5,2,4,1,1,2,3,2,1,2,1,2,2,1,1,2,1,1,1,2,1,1,1,1,4,2,4,2,4,3,2,1,3,4,4,3,2
441,2,4,1,1,1,2,1,2,3,1,3,2,2,2,8,1,1,1,3,2,1,2,1,1,2,3,1,2,3,2,3,1,3,2,5,2,2,1,4,5,2,3,2,3,3,1,3,2,2,1,2,1,3,2,3,4,3,4,4,5,5,3,2,2,1,3,5,1,2,3,2,3,1,3,4,5,2,3,2,1,4,3,2,2,3,2,2,2,1,1,2,1,2,2,1,1,1,1,2,2,1,1,4,4,2,2,4,3,1,3,1,4,4,5,2
442,1,2,1,2,0,0,1,2,3,2,2,3,1,3,8,2,1,3,3,2,2,3,3,3,2,2,3,1,3,4,3,3,3,2,3,2,1,2,1,3,2,3,3,3,3,2,2,4,1,1,2,2,2,5,2,4,3,3,3,2,5,4,4,2,3,4,5,4,3,5,3,2,2,3,3,3,4,4,5,2,4,1,1,1,1,2,2,2,1,2,2,1,1,2,1,2,2,2,2,2,2,1,3,3,2,2,3,2,2,4,4,3,4,4,3
443,2,4,1,2,0,0,2,1,3,2,2,2,1,2,8,1,1,3,3,2,2,3,3,3,4,2,2,3,3,4,4,3,3,2,3,5,1,2,1,3,2,3,2,2,4,2,2,4,1,1,2,2,3,2,2,4,3,3,3,2,5,4,4,2,3,4,4,4,3,5,3,2,2,3,3,3,3,4,4,3,4,1,1,1,2,1,1,2,1,2,2,1,1,2,1,2,2,2,2,1,2,1,2,3,2,2,3,2,2,4,4,3,4,5,3
444,2,1,2,2,0,0,1,2,3,2,2,3,1,1,8,1,1,5,4,3,4,2,5,1,3,2,2,5,3,4,3,1,2,3,2,2,1,4,1,3,1,1,3,3,1,1,2,2,1,4,1,1,1,1,1,1,3,1,3,3,2,1,1,1,3,3,2,2,1,4,1,1,1,1,2,3,2,3,3,3,4,4,3,2,2,1,1,1,1,1,1,2,2,1,1,1,2,2,1,1,1,1,2,4,3,2,4,3,3,4,3,2,5,4,4
445,1,2,1,1,1,1,1,1,4,3,1,4,1,2,8,2,1,2,2,2,3,3,5,4,3,4,2,4,2,3,4,1,2,3,4,2,1,1,2,3,1,1,3,4,3,2,2,3,1,1,1,1,1,1,3,3,3,2,3,3,4,4,3,1,3,3,4,4,1,5,3,4,1,2,3,3,2,3,3,3,2,4,3,3,2,1,1,1,2,1,1,2,2,2,1,1,2,2,2,1,1,1,3,4,4,3,4,4,3,4,3,2,4,5,3
446,1,3,1,2,0,0,2,2,2,1,3,2,2,2,8,1,2,4,4,3,2,1,1,1,1,1,1,1,1,3,1,2,2,5,2,3,2,1,2,4,1,2,2,3,3,2,1,2,2,2,3,2,2,3,2,2,3,3,3,4,5,4,3,2,2,2,3,2,3,5,4,1,2,3,2,4,4,3,4,2,3,3,4,5,5,1,1,2,1,1,1,1,1,1,1,1,1,1,1,1,2,1,1,1,1,1,1,1,1,3,4,1,5,5,3
447,1,2,3,1,2,0,2,2,1,1,3,3,2,3,8,1,1,5,5,2,3,2,3,3,2,2,3,3,3,3,2,3,3,3,3,4,2,3,3,3,4,4,3,2,3,1,3,5,2,3,3,3,3,2,3,3,4,2,2,3,3,3,3,3,3,3,4,2,3,4,4,2,3,4,4,3,1,3,4,2,3,4,3,2,2,2,2,2,2,2,2,2,2,2,2,2,2,2,2,2,1,1,4,3,3,2,4,4,3,2,3,2,5,5,2
448,2,2,1,1,1,3,1,2,4,3,2,1,1,3,8,1,1,2,1,1,2,2,3,2,3,2,3,4,2,3,3,1,1,2,3,2,2,2,2,2,2,3,3,2,2,2,2,2,1,2,2,1,3,2,2,4,3,3,2,2,2,5,5,1,1,1,1,1,1,2,2,2,2,3,4,2,2,1,3,4,3,3,4,4,4,2,1,2,1,2,1,1,1,1,1,1,1,2,2,1,1,1,2,1,2,3,5,4,2,3,4,2,5,4,4
449,1,3,1,2,0,0,2,1,4,2,1,4,3,2,8,2,1,2,2,3,2,4,3,3,2,3,4,4,1,3,2,4,2,3,3,3,2,2,2,4,3,1,4,1,3,1,2,3,1,1,1,2,1,1,1,3,3,4,4,3,4,3,4,2,2,5,5,4,1,4,3,1,5,3,1,1,1,3,3,1,5,3,3,2,2,1,1,2,1,1,2,1,1,1,1,1,1,1,2,2,2,2,2,4,3,3,2,1,3,4,3,1,5,5,3
450,2,4,1,1,1,2,1,2,1,1,3,1,2,1,8,1,2,1,1,1,1,1,4,2,4,3,3,3,3,3,3,2,2,1,3,2,2,2,3,4,3,3,2,2,2,1,4,3,2,3,3,3,4,4,5,5,4,3,5,2,2,2,2,1,1,1,1,1,1,1,1,1,1,1,3,2,3,3,4,3,5,3,3,2,2,2,1,1,1,1,1,1,1,1,1,1,1,1,1,1,1,1,1,1,1,1,3,4,2,2,3,2,4,4,2
451,1,2,3,1,1,2,2,2,3,4,2,3,1,3,8,2,1,2,2,1,1,1,3,5,4,4,2,4,2,4,3,3,3,4,4,3,2,5,4,5,3,3,3,2,3,2,2,5,2,4,1,4,4,1,2,2,5,4,4,3,4,4,3,1,5,3,2,5,4,5,4,3,5,4,4,4,4,5,4,4,4,1,1,2,1,2,2,2,1,2,2,1,1,2,1,1,2,2,2,2,1,1,3,2,2,3,4,4,4,4,4,3,3,3,1
452,1,1,1,2,0,0,1,2,3,2,2,1,1,2,8,1,2,2,2,3,1,3,1,1,2,3,2,3,2,3,4,5,2,2,4,2,1,4,1,2,1,2,1,1,3,1,1,2,1,1,1,1,3,4,2,4,5,5,2,5,2,3,5,1,3,2,4,5,2,4,3,3,5,5,4,5,5,5,5,4,5,5,3,5,5,2,1,2,1,2,2,1,1,2,1,1,2,2,1,1,1,1,4,2,4,4,2,3,2,2,4,2,4,4,2
453,1,2,1,1,2,0,2,2,3,2,2,3,1,2,9,2,1,4,4,2,3,2,2,2,5,2,5,5,3,5,5,3,5,4,5,5,2,3,1,3,5,4,5,3,5,4,2,5,1,5,2,3,2,3,4,1,5,4,3,2,4,3,2,1,3,5,5,5,5,5,3,2,5,5,5,5,3,5,5,5,4,5,2,3,1,2,2,2,1,1,2,2,1,2,1,1,2,2,2,2,1,1,5,3,2,5,4,3,3,5,2,3,5,4,3
454,1,4,1,1,1,3,1,1,3,3,2,2,2,3,9,1,1,3,2,1,3,4,1,1,1,1,1,1,2,1,4,3,2,2,2,2,2,3,1,3,2,3,2,5,5,2,1,2,1,1,1,2,2,2,1,2,1,2,1,1,3,3,3,1,1,2,2,2,4,3,1,1,3,4,3,5,2,2,1,2,5,5,1,5,5,2,2,2,2,2,2,1,2,2,1,1,1,2,2,1,1,1,3,2,2,2,4,4,3,4,3,3,2,2,2
455,2,2,2,2,0,0,2,2,1,1,3,2,1,3,9,1,1,3,2,2,1,5,2,1,1,1,2,2,2,5,2,1,2,5,1,5,1,5,3,2,3,3,3,3,5,1,1,1,3,1,1,1,1,1,1,4,4,4,5,3,2,2,2,1,1,3,3,5,5,3,4,4,5,4,4,4,3,5,5,3,4,5,1,5,5,2,2,2,1,2,2,2,2,2,1,1,2,2,2,1,2,1,2,1,2,5,4,4,3,3,4,2,4,5,2
456,1,1,1,2,0,0,1,2,3,2,2,3,3,2,9,1,1,5,1,4,5,5,5,3,4,4,5,2,5,5,5,3,3,5,2,5,4,4,5,4,2,3,3,4,5,2,5,1,5,5,5,3,3,1,5,4,5,5,5,5,5,2,3,3,5,4,4,2,4,4,5,5,2,2,5,5,2,5,5,5,5,5,5,1,3,2,2,2,2,1,1,1,1,2,1,1,1,2,2,1,2,1,5,2,3,1,5,5,1,3,3,4,5,5,2
457,1,3,1,1,1,3,2,2,1,1,3,1,1,2,9,1,1,3,5,2,5,2,5,1,3,1,2,3,4,5,5,5,4,3,2,5,5,3,2,1,2,3,1,1,4,1,4,5,3,1,2,4,3,1,1,3,5,5,4,3,5,5,5,1,3,5,5,5,5,4,3,3,2,4,5,2,1,3,3,2,5,3,3,5,5,1,2,2,1,1,2,1,1,1,2,1,2,2,1,1,1,1,3,2,2,3,4,3,2,2,4,2,5,5,3
458,1,2,1,1,1,3,1,1,4,4,1,4,1,2,9,2,1,2,2,2,2,3,4,1,2,2,5,2,1,3,3,2,3,2,3,2,2,4,4,4,4,2,2,2,2,2,3,3,2,2,2,2,2,2,2,3,2,2,3,3,3,3,3,3,3,3,3,3,3,2,3,3,3,3,3,3,3,3,3,3,3,3,2,3,3,1,1,2,1,1,1,1,2,1,1,1,1,1,1,1,1,1,3,2,2,2,2,2,3,1,3,2,1,1,3
459,1,2,1,1,2,0,2,2,3,2,2,1,1,1,9,1,1,4,5,2,5,4,4,2,3,4,1,3,5,5,4,4,3,1,4,2,2,5,4,3,3,5,2,2,2,2,3,4,2,4,1,3,3,2,1,4,2,1,4,1,3,3,3,3,3,3,4,5,1,5,3,5,5,3,3,5,1,3,3,2,5,5,5,1,1,1,2,2,2,1,2,2,1,2,1,1,2,2,2,1,2,1,5,4,5,4,4,3,3,3,5,3,4,3,5
460,1,1,3,1,1,1,2,2,3,3,2,3,2,3,9,2,1,5,4,2,2,1,1,1,5,2,3,5,3,1,4,1,4,2,4,2,3,3,5,3,2,2,4,2,5,3,4,3,2,3,2,2,2,2,3,2,4,4,4,3,4,4,4,2,4,3,4,3,3,4,4,4,3,4,4,4,3,4,4,4,4,3,2,2,2,2,2,2,2,1,2,2,1,2,2,1,2,2,1,1,1,1,2,3,3,4,4,4,2,4,3,2,5,5,2
461,1,3,1,1,2,0,1,2,3,2,2,2,1,2,9,1,1,3,3,2,3,2,4,2,4,4,3,3,3,2,4,4,3,3,2,3,2,2,1,2,3,3,3,3,4,2,2,2,2,3,2,4,3,2,3,2,3,4,4,2,4,4,4,2,3,4,4,4,4,3,2,4,4,3,5,3,2,4,4,3,4,2,2,2,2,2,1,2,1,1,2,1,1,2,1,1,2,2,2,2,2,1,4,4,4,4,3,4,2,4,3,3,3,4,2
462,2,2,1,2,0,0,2,1,4,2,1,4,2,4,9,1,1,3,3,3,2,1,1,3,2,2,3,1,3,3,4,3,3,3,3,3,2,2,2,3,3,2,3,1,3,2,2,2,4,1,1,1,1,1,2,2,2,2,3,2,2,3,3,4,2,1,1,3,2,2,3,3,3,3,3,3,4,4,2,2,2,3,4,3,3,2,1,1,1,2,2,2,2,2,1,1,2,2,2,2,1,2,2,1,2,3,4,4,3,3,3,1,4,5,3
463,1,4,1,1,2,0,1,2,1,1,3,3,1,3,9,1,2,5,5,5,5,3,3,2,3,3,4,5,4,2,4,3,3,3,5,4,2,5,3,2,5,4,4,3,5,5,3,3,3,3,2,2,2,1,3,3,3,3,3,3,3,5,3,1,1,3,1,5,5,3,3,3,5,3,3,3,3,5,3,3,5,3,4,2,2,2,2,1,1,2,2,2,2,2,1,1,2,2,2,2,1,1,2,3,2,4,4,4,4,2,4,3,5,5,3
464,1,2,2,1,1,2,2,2,3,3,2,1,2,2,9,1,2,3,2,1,3,3,3,1,3,3,5,5,5,3,1,5,5,4,2,1,3,5,1,3,1,3,3,3,3,1,2,3,1,1,1,3,4,2,2,2,4,4,3,2,4,3,3,5,4,2,4,1,5,5,1,3,5,4,5,3,3,3,4,4,4,4,3,2,1,2,1,1,1,1,2,1,2,2,1,1,1,2,1,2,1,1,4,5,2,1,5,4,5,4,2,1,5,5,2
465,1,3,1,1,2,0,1,2,4,2,1,4,1,1,9,1,1,2,2,1,4,3,5,4,5,3,1,4,2,4,2,1,4,3,5,3,1,3,1,3,1,2,3,2,5,2,3,4,1,3,3,3,3,2,5,5,3,2,3,3,2,4,3,1,3,3,4,5,4,4,3,3,3,3,4,2,3,3,3,5,1,1,1,1,3,1,1,1,1,1,2,1,1,2,1,1,2,2,2,2,1,1,3,4,4,4,4,5,2,4,4,3,4,5,4
466,1,2,1,2,0,0,2,2,3,2,2,3,1,2,9,1,1,3,3,2,3,3,4,2,3,4,4,4,3,3,3,1,2,3,3,2,2,4,2,2,2,2,2,1,3,2,3,2,3,4,4,4,4,2,2,2,4,4,4,3,1,2,4,3,4,4,4,3,2,4,2,3,3,4,4,3,2,4,3,3,4,4,2,2,1,2,2,1,1,2,2,2,1,1,2,1,2,2,2,2,1,1,4,2,5,4,4,4,5,3,4,5,5,5,4
467,1,1,1,1,2,0,1,1,3,2,2,2,1,2,9,2,1,3,3,2,3,5,5,4,3,4,2,4,4,4,3,5,1,2,2,3,5,3,1,5,3,4,4,3,4,1,2,5,2,3,1,5,4,2,3,2,2,3,4,3,3,2,2,3,3,2,2,1,4,2,3,4,2,4,4,2,2,5,5,4,5,1,4,1,2,2,1,2,1,1,2,1,2,2,1,2,1,1,1,1,2,2,3,4,4,5,4,2,2,3,4,3,3,3,3
468,2,4,1,1,1,2,2,2,1,1,3,3,2,4,9,1,2,2,3,2,5,3,4,5,2,1,2,2,2,4,2,3,2,2,1,2,2,4,1,3,1,2,3,2,2,1,2,2,1,5,3,2,5,1,2,1,4,4,2,3,3,4,3,1,1,1,2,4,3,5,3,4,1,4,3,4,1,4,4,2,3,5,2,1,4,2,2,2,1,1,1,1,1,2,1,1,1,1,1,1,1,1,1,1,1,5,5,3,3,3,2,1,5,4,4
469,1,2,1,1,2,0,1,1,3,2,2,1,1,2,9,1,1,4,4,5,5,4,3,2,2,3,1,4,4,2,5,3,5,3,2,3,3,1,1,3,3,3,4,3,5,1,2,4,3,4,3,5,4,2,3,3,3,5,2,2,4,4,4,2,2,4,4,3,4,5,5,3,3,4,5,3,2,4,4,2,5,3,2,2,2,2,2,2,2,2,2,1,1,1,1,1,2,1,1,2,1,1,3,3,3,2,4,3,3,3,2,3,4,4,2
470,1,3,3,1,1,3,2,2,4,3,1,4,1,3,9,1,1,3,4,3,2,2,3,1,3,5,2,3,4,2,2,2,3,2,2,1,2,2,2,2,2,4,2,4,5,2,3,4,2,3,2,4,3,2,1,3,3,4,3,3,4,3,3,3,4,3,2,3,4,4,5,4,4,2,5,3,4,5,5,2,4,1,1,2,3,2,1,2,1,2,2,1,1,2,1,1,1,2,1,1,1,1,4,2,4,2,4,3,2,1,3,4,4,3,2
471,2,1,1,2,0,0,1,1,3,2,2,3,1,1,9,1,2,1,3,2,1,2,1,1,2,3,1,2,3,2,3,4,3,2,5,2,2,1,4,5,2,3,2,3,3,1,3,2,2,1,2,1,3,2,3,4,3,4,4,5,5,3,2,2,1,3,5,1,2,3,2,3,1,3,4,5,2,3,2,1,4,3,2,2,3,2,2,2,1,1,2,1,2,2,1,1,1,1,2,2,1,1,4,4,2,2,4,3,1,3,1,4,4,5,2
472,1,3,1,1,2,0,2,2,2,1,3,2,2,4,9,1,1,3,3,2,2,3,3,3,2,2,3,3,3,4,3,3,1,2,3,2,1,2,1,3,2,3,3,3,3,2,2,4,1,1,2,2,2,5,2,4,3,3,3,2,5,4,4,2,3,4,5,4,3,5,3,2,2,3,3,3,4,4,5,2,4,1,1,1,1,2,2,2,1,2,2,1,1,2,1,2,2,2,2,2,2,1,3,3,3,2,3,2,2,4,4,3,4,4,3
473,2,2,1,1,1,2,1,2,3,3,2,3,1,2,9,2,2,3,3,2,2,3,3,3,4,2,2,3,3,4,4,3,3,2,3,5,1,2,1,3,2,3,2,2,4,2,2,4,1,1,2,2,3,2,2,4,3,3,3,2,5,4,4,2,3,4,4,4,3,5,3,2,2,3,3,3,3,4,4,3,4,1,1,1,2,1,1,2,1,2,2,1,1,2,1,2,2,2,2,1,2,1,2,3,2,2,3,2,2,4,4,3,4,5,3
474,1,4,1,1,2,0,2,1,3,2,2,1,1,1,9,1,1,5,4,3,4,2,5,1,3,2,2,5,3,4,3,1,2,3,2,2,1,4,1,3,1,1,3,3,1,1,2,2,1,4,1,1,1,1,1,1,3,1,3,3,2,1,1,1,3,3,2,2,1,4,1,1,1,1,2,3,2,3,3,3,4,4,3,2,2,1,1,1,1,1,1,2,2,1,1,1,2,2,1,1,1,1,2,4,2,3,4,3,3,4,3,2,5,4,4
475,2,3,1,1,1,2,2,2,4,4,1,4,1,2,9,2,1,2,2,2,3,3,5,4,3,4,2,4,2,3,4,1,2,3,4,2,1,1,2,3,1,1,3,3,3,2,2,3,1,1,1,1,1,1,3,3,3,2,3,3,4,4,3,1,3,3,4,4,1,5,3,4,1,2,3,3,2,3,3,3,2,4,3,3,2,1,1,1,2,1,1,2,2,2,1,1,2,2,2,1,1,1,3,4,4,3,4,4,3,4,3,2,4,5,3
476,1,2,3,2,0,0,2,2,3,2,2,1,1,1,9,1,2,4,4,3,2,1,1,1,1,1,1,1,1,3,1,2,2,5,2,3,2,1,2,4,1,2,2,3,3,2,1,2,2,2,3,2,2,3,2,2,3,3,3,4,5,4,3,2,2,2,3,2,3,5,4,1,2,3,2,4,4,3,4,2,3,3,4,5,5,1,1,2,1,1,1,1,1,1,1,1,1,1,1,1,2,1,1,1,1,1,1,1,1,3,4,1,5,5,3
477,2,2,1,2,0,0,2,2,3,2,2,2,1,3,9,1,1,5,5,2,3,2,3,3,2,2,3,1,3,3,2,3,3,3,3,4,2,3,3,3,4,4,3,2,3,1,3,5,2,3,3,3,3,2,3,3,4,2,2,3,3,3,3,3,3,3,4,2,3,4,4,2,3,4,4,3,1,3,4,2,3,4,3,2,2,2,2,2,2,2,2,2,2,2,2,2,2,2,2,2,1,1,4,3,1,2,4,4,3,2,3,2,5,5,2
478,1,3,1,2,0,0,2,1,1,1,3,3,2,1,9,2,2,2,1,1,2,2,3,2,3,2,3,4,2,3,3,1,1,2,3,2,2,2,2,2,2,3,3,2,2,2,2,2,1,2,2,1,3,2,2,4,3,3,2,2,2,5,5,1,1,1,1,1,1,2,2,2,2,3,4,2,2,1,3,4,3,3,4,4,4,2,1,2,1,2,1,1,1,1,1,1,1,2,2,1,1,1,2,1,2,2,5,4,2,3,4,2,5,4,4
479,1,2,1,1,1,3,1,2,3,3,2,2,1,2,9,2,2,2,2,3,2,4,3,3,2,3,4,4,1,3,2,1,2,3,3,3,2,2,2,4,3,1,4,1,3,1,2,3,1,1,1,2,1,1,1,3,3,4,4,3,4,3,4,2,2,5,5,4,1,4,3,1,5,3,1,1,1,3,3,1,5,3,3,2,2,1,1,2,1,1,2,1,1,1,1,1,1,1,2,2,2,2,2,4,3,2,2,1,2,4,3,1,5,5,3
480,2,1,2,1,1,2,2,1,4,3,1,4,1,1,9,2,1,1,1,1,1,1,4,2,4,3,3,3,3,3,3,2,2,1,3,2,2,2,3,4,3,3,2,2,2,1,4,3,2,3,3,3,4,4,5,5,4,3,5,2,2,2,2,1,1,1,1,1,1,1,1,1,1,1,3,2,3,3,4,3,5,3,3,2,2,2,1,1,1,1,1,1,1,1,1,1,1,1,1,1,1,1,1,1,1,1,3,4,2,2,3,2,4,4,2
481,1,3,1,1,1,2,2,2,3,2,2,1,1,4,9,1,1,5,5,2,3,2,3,3,2,2,3,1,3,3,2,3,3,3,3,4,2,3,3,3,4,4,3,2,3,1,3,5,2,3,3,3,3,2,3,3,4,2,2,3,3,3,3,3,3,3,4,2,3,4,4,2,3,4,4,3,1,3,4,2,3,4,3,2,2,2,2,2,2,2,2,2,2,2,2,2,2,2,2,2,1,1,4,2,1,2,4,4,3,2,3,2,5,5,2
482,1,4,1,1,1,2,1,2,3,4,2,3,1,1,9,1,1,2,1,1,2,2,3,2,3,2,3,4,2,3,3,1,1,2,3,2,2,2,2,2,2,3,3,2,2,2,2,2,1,2,2,1,3,2,2,4,3,3,2,2,2,5,5,1,1,1,1,1,1,2,2,2,2,3,4,2,2,1,3,4,3,3,4,4,4,2,1,2,1,2,1,1,1,1,1,1,1,2,2,1,1,1,2,1,2,3,5,4,2,3,4,2,5,4,4
483,2,2,1,1,1,3,2,2,3,3,2,1,1,3,9,2,2,2,2,3,2,4,3,3,2,3,4,4,1,3,2,4,2,3,3,3,2,2,2,4,3,1,4,1,3,1,2,3,1,1,1,2,1,1,1,3,3,4,4,3,4,3,4,2,2,5,5,4,1,4,3,1,5,3,1,1,1,3,3,1,5,3,3,2,2,1,1,2,1,1,2,1,1,1,1,1,1,1,2,2,2,2,2,4,2,3,2,1,2,4,3,1,5,5,3
484,1,1,1,1,1,3,2,1,4,3,1,4,1,1,9,2,1,1,1,1,1,1,4,2,4,3,3,3,3,3,3,2,2,1,3,2,2,2,3,4,3,3,2,2,2,1,4,3,2,3,3,3,4,4,5,5,4,3,5,2,2,2,2,1,1,1,1,1,1,1,1,1,1,1,3,2,3,3,4,3,5,3,3,2,2,2,1,1,1,1,1,1,1,1,1,1,1,1,1,1,1,1,1,1,1,1,3,4,2,2,3,2,4,4,2
485,1,3,3,2,0,0,1,2,2,1,3,2,2,1,9,1,1,2,2,1,1,1,3,5,4,4,2,4,2,4,3,3,3,4,4,3,2,5,4,5,3,3,3,2,3,2,2,5,2,4,1,4,4,1,2,2,5,4,4,3,4,4,3,1,5,3,2,5,4,5,4,3,5,4,4,4,4,5,4,4,4,1,1,2,1,2,2,2,1,2,2,1,1,2,1,1,2,2,2,2,1,1,3,3,3,3,4,4,4,4,4,3,3,3,1
486,1,1,1,1,2,0,2,1,3,2,2,3,1,2,11,1,1,2,2,3,1,3,1,1,2,3,2,3,2,3,4,5,2,2,4,2,1,4,1,2,1,2,1,1,3,1,1,2,1,1,1,1,3,4,2,4,5,5,2,5,2,3,5,1,3,2,4,5,2,4,3,3,5,5,4,5,5,5,5,4,5,5,3,5,5,2,1,2,1,2,2,1,1,2,1,1,2,2,1,1,1,1,4,2,4,4,2,3,2,2,4,2,4,4,2
487,2,2,3,1,1,2,2,2,3,2,2,2,1,3,11,2,2,4,4,2,3,2,2,2,5,2,5,5,3,5,5,3,5,4,5,5,2,3,1,3,5,4,5,4,5,4,2,5,1,5,2,3,2,3,4,1,5,4,3,2,4,3,2,1,3,5,5,5,5,5,3,2,5,5,5,5,3,5,5,5,4,5,2,3,1,2,2,2,1,1,2,2,1,2,1,1,2,2,2,2,1,1,5,3,3,5,4,3,3,5,2,3,5,4,3
488,1,4,1,1,1,2,1,1,4,3,1,4,1,1,11,1,1,3,2,1,3,4,1,1,1,1,1,1,2,1,4,3,2,2,2,2,2,3,1,3,2,3,2,5,5,2,1,2,1,1,1,2,2,2,1,2,1,2,1,1,3,3,3,1,1,2,2,2,4,3,1,1,3,4,3,5,2,2,1,2,5,5,1,5,5,2,2,2,2,2,2,1,2,2,1,1,1,2,2,1,1,1,3,2,2,2,4,4,3,4,3,3,2,2,2
489,2,1,1,1,1,2,2,2,1,1,3,1,2,3,11,2,2,3,2,2,1,5,2,1,1,1,2,2,2,5,2,5,2,5,1,5,1,5,3,2,3,3,3,3,5,1,1,1,3,1,1,1,1,1,1,4,4,4,5,3,2,2,2,1,1,3,3,5,5,3,4,4,5,4,4,4,3,5,5,3,4,5,1,5,5,2,2,2,1,2,2,2,2,2,1,1,2,2,2,1,2,1,3,1,1,5,4,4,3,3,4,2,4,5,2
490,1,3,1,1,2,0,1,1,3,2,2,3,1,1,11,1,1,5,1,4,5,5,5,3,4,4,5,2,5,5,5,3,3,5,2,5,4,4,5,4,2,3,3,3,5,2,5,1,5,5,5,3,3,1,5,4,5,5,5,5,5,2,3,3,5,4,4,2,4,4,5,5,2,2,5,5,2,5,5,5,5,5,5,1,3,2,2,2,2,1,1,1,1,2,1,1,1,2,2,1,2,1,5,2,3,1,5,5,1,3,3,4,5,5,2
491,1,2,1,1,1,3,2,2,3,2,2,1,1,2,11,2,2,3,5,2,5,2,5,1,3,1,2,3,4,5,5,5,4,3,2,5,5,3,2,1,4,3,1,1,4,1,4,5,3,1,2,4,3,1,1,3,5,5,4,3,5,5,5,1,3,5,5,5,5,4,3,3,2,4,5,2,1,3,3,2,5,3,3,5,5,1,2,2,1,1,2,1,1,1,2,1,2,2,1,1,1,1,3,2,2,3,4,3,2,2,4,2,5,5,3
492,2,1,1,2,0,0,1,1,3,2,1,3,1,1,11,1,1,2,2,2,2,3,4,1,2,2,5,2,1,3,3,2,1,2,3,2,2,4,4,4,2,2,2,2,2,2,3,3,2,2,2,2,2,2,2,3,2,2,3,3,3,3,3,3,3,3,3,3,3,2,3,3,3,3,3,3,3,3,3,3,3,3,2,3,3,1,1,2,1,1,1,1,2,1,1,1,1,1,1,1,1,1,3,2,2,3,2,2,3,1,3,2,1,1,3
493,1,3,2,1,1,2,2,1,3,4,2,2,1,3,11,2,1,4,5,2,5,4,4,2,3,4,1,1,5,5,4,4,3,2,4,2,2,5,4,3,3,5,2,2,2,2,3,4,2,4,1,3,3,2,1,4,2,1,4,1,3,3,3,3,3,3,4,5,1,5,3,5,5,3,3,5,1,3,3,2,5,5,5,1,1,1,2,2,2,1,2,2,1,2,1,1,2,2,2,1,2,1,5,4,5,4,4,3,2,3,5,3,4,3,5
494,2,1,1,2,0,0,1,2,3,2,1,4,1,1,11,1,1,5,4,2,2,1,1,1,5,2,3,5,3,1,1,1,4,2,4,2,3,3,5,3,2,2,4,2,5,3,4,3,2,3,2,2,2,2,3,2,4,4,4,3,4,4,4,2,4,3,4,3,3,4,4,4,3,4,4,4,3,4,4,4,4,3,2,2,2,2,2,2,2,1,2,2,1,2,2,1,2,2,1,1,1,1,2,2,1,4,4,4,3,4,3,2,5,5,2
495,1,2,2,1,2,0,1,2,3,1,3,2,2,2,11,2,2,3,3,2,3,2,4,2,4,4,3,3,3,2,4,4,3,3,2,3,2,2,1,2,3,3,3,3,4,2,2,2,2,3,2,4,3,2,3,2,3,4,4,2,4,4,4,2,3,4,4,4,4,3,2,4,4,3,5,3,2,4,4,3,4,2,2,2,2,2,1,2,1,1,2,1,1,2,1,1,2,2,2,2,2,1,4,4,4,4,3,4,3,4,3,3,3,4,2
496,1,4,1,1,1,2,2,2,3,2,2,3,1,3,11,1,1,3,3,3,2,1,1,3,2,2,3,3,3,3,4,3,3,3,3,3,2,2,2,3,3,2,3,1,3,2,2,2,4,1,1,1,1,1,2,2,2,2,3,2,2,3,3,4,2,1,1,3,2,2,3,3,3,3,3,3,4,4,2,2,2,3,4,3,3,2,1,1,1,2,2,2,2,2,1,1,2,2,2,2,1,2,2,1,1,3,4,4,2,3,3,1,4,5,3
